area,prov,dist,agegrp,area_name,agegrpname,rowtotal,a_male,b_female
10,0,0,0,"Nepal","All Ages",29164578,14253551,14911027
10,0,0,1,"Nepal","00-04 Yrs.",2439283,1290525,1148758
10,0,0,2,"Nepal","05-09 Yrs.",2766427,1443405,1323022
10,0,0,3,"Nepal","10-14 Yrs.",2909865,1495954,1413911
10,0,0,4,"Nepal","15-19 Yrs.",2966404,1494523,1471881
10,0,0,5,"Nepal","20-24 Yrs.",2783060,1301019,1482041
10,0,0,6,"Nepal","25-29 Yrs.",2459349,1122242,1337107
10,0,0,7,"Nepal","30-34 Yrs.",2147712,978976,1168736
10,0,0,8,"Nepal","35-39 Yrs.",2041492,936931,1104561
10,0,0,9,"Nepal","40-44 Yrs.",1747832,828493,919339
10,0,0,10,"Nepal","45-49 Yrs.",1436039,687524,748515
10,0,0,11,"Nepal","50-54 Yrs.",1413851,692494,721357
10,0,0,12,"Nepal","55-59 Yrs.",1075944,537558,538386
10,0,0,13,"Nepal","60-64 Yrs.",955604,465962,489642
10,0,0,14,"Nepal","65-69 Yrs.",771618,379689,391929
10,0,0,15,"Nepal","70-74 Yrs.",609370,292054,317316
10,0,0,16,"Nepal","75-79 Yrs.",353203,170998,182205
10,0,0,17,"Nepal","80-84 Yrs.",161556,78315,83241
10,0,0,18,"Nepal","85-89 Yrs.",76427,36167,40260
10,0,0,19,"Nepal","90-94 Yrs.",30406,13191,17215
10,0,0,20,"Nepal","95+ Yrs.",19136,7531,11605
21,0,0,0,"Urban Munipalities","All Ages",19296788,9454545,9842243
21,0,0,1,"Urban Munipalities","00-04 Yrs.",1547101,824323,722778
21,0,0,2,"Urban Munipalities","05-09 Yrs.",1774077,934436,839641
21,0,0,3,"Urban Munipalities","10-14 Yrs.",1852039,960918,891121
21,0,0,4,"Urban Munipalities","15-19 Yrs.",1940957,987059,953898
21,0,0,5,"Urban Munipalities","20-24 Yrs.",1878407,882667,995740
21,0,0,6,"Urban Munipalities","25-29 Yrs.",1683327,762951,920376
21,0,0,7,"Urban Munipalities","30-34 Yrs.",1493100,677051,816049
21,0,0,8,"Urban Munipalities","35-39 Yrs.",1419444,652295,767149
21,0,0,9,"Urban Munipalities","40-44 Yrs.",1209833,577363,632470
21,0,0,10,"Urban Munipalities","45-49 Yrs.",974426,471192,503234
21,0,0,11,"Urban Munipalities","50-54 Yrs.",938060,463564,474496
21,0,0,12,"Urban Munipalities","55-59 Yrs.",698332,349650,348682
21,0,0,13,"Urban Munipalities","60-64 Yrs.",611219,297728,313491
21,0,0,14,"Urban Munipalities","65-69 Yrs.",487835,239026,248809
21,0,0,15,"Urban Munipalities","70-74 Yrs.",381533,182222,199311
21,0,0,16,"Urban Munipalities","75-79 Yrs.",222031,106283,115748
21,0,0,17,"Urban Munipalities","80-84 Yrs.",102776,49194,53582
21,0,0,18,"Urban Munipalities","85-89 Yrs.",50178,23376,26802
21,0,0,19,"Urban Munipalities","90-94 Yrs.",19883,8547,11336
21,0,0,20,"Urban Munipalities","95+ Yrs.",12230,4700,7530
22,0,0,0,"Rural Municipalities","All Ages",9867790,4799006,5068784
22,0,0,1,"Rural Municipalities","00-04 Yrs.",892182,466202,425980
22,0,0,2,"Rural Municipalities","05-09 Yrs.",992350,508969,483381
22,0,0,3,"Rural Municipalities","10-14 Yrs.",1057826,535036,522790
22,0,0,4,"Rural Municipalities","15-19 Yrs.",1025447,507464,517983
22,0,0,5,"Rural Municipalities","20-24 Yrs.",904653,418352,486301
22,0,0,6,"Rural Municipalities","25-29 Yrs.",776022,359291,416731
22,0,0,7,"Rural Municipalities","30-34 Yrs.",654612,301925,352687
22,0,0,8,"Rural Municipalities","35-39 Yrs.",622048,284636,337412
22,0,0,9,"Rural Municipalities","40-44 Yrs.",537999,251130,286869
22,0,0,10,"Rural Municipalities","45-49 Yrs.",461613,216332,245281
22,0,0,11,"Rural Municipalities","50-54 Yrs.",475791,228930,246861
22,0,0,12,"Rural Municipalities","55-59 Yrs.",377612,187908,189704
22,0,0,13,"Rural Municipalities","60-64 Yrs.",344385,168234,176151
22,0,0,14,"Rural Municipalities","65-69 Yrs.",283783,140663,143120
22,0,0,15,"Rural Municipalities","70-74 Yrs.",227837,109832,118005
22,0,0,16,"Rural Municipalities","75-79 Yrs.",131172,64715,66457
22,0,0,17,"Rural Municipalities","80-84 Yrs.",58780,29121,29659
22,0,0,18,"Rural Municipalities","85-89 Yrs.",26249,12791,13458
22,0,0,19,"Rural Municipalities","90-94 Yrs.",10523,4644,5879
22,0,0,20,"Rural Municipalities","95+ Yrs.",6906,2831,4075
31,0,0,0,"Mountain","All Ages",1772948,874260,898688
31,0,0,1,"Mountain","00-04 Yrs.",154494,80524,73970
31,0,0,2,"Mountain","05-09 Yrs.",177911,90587,87324
31,0,0,3,"Mountain","10-14 Yrs.",200201,100663,99538
31,0,0,4,"Mountain","15-19 Yrs.",187196,90917,96279
31,0,0,5,"Mountain","20-24 Yrs.",162485,77272,85213
31,0,0,6,"Mountain","25-29 Yrs.",136792,68070,68722
31,0,0,7,"Mountain","30-34 Yrs.",116963,57644,59319
31,0,0,8,"Mountain","35-39 Yrs.",108757,53138,55619
31,0,0,9,"Mountain","40-44 Yrs.",95495,45313,50182
31,0,0,10,"Mountain","45-49 Yrs.",82858,39795,43063
31,0,0,11,"Mountain","50-54 Yrs.",85379,41723,43656
31,0,0,12,"Mountain","55-59 Yrs.",68362,34310,34052
31,0,0,13,"Mountain","60-64 Yrs.",63683,31271,32412
31,0,0,14,"Mountain","65-69 Yrs.",48905,24279,24626
31,0,0,15,"Mountain","70-74 Yrs.",40353,18775,21578
31,0,0,16,"Mountain","75-79 Yrs.",23682,11095,12587
31,0,0,17,"Mountain","80-84 Yrs.",11472,5473,5999
31,0,0,18,"Mountain","85-89 Yrs.",5165,2342,2823
31,0,0,19,"Mountain","90-94 Yrs.",1859,716,1143
31,0,0,20,"Mountain","95+ Yrs.",936,353,583
32,0,0,0,"Hill","All Ages",11757624,5717247,6040377
32,0,0,1,"Hill","00-04 Yrs.",877990,463167,414823
32,0,0,2,"Hill","05-09 Yrs.",1003713,524548,479165
32,0,0,3,"Hill","10-14 Yrs.",1105998,568487,537511
32,0,0,4,"Hill","15-19 Yrs.",1184235,593888,590347
32,0,0,5,"Hill","20-24 Yrs.",1132282,535107,597175
32,0,0,6,"Hill","25-29 Yrs.",1010564,468013,542551
32,0,0,7,"Hill","30-34 Yrs.",894389,415167,479222
32,0,0,8,"Hill","35-39 Yrs.",824631,382560,442071
32,0,0,9,"Hill","40-44 Yrs.",727015,337419,389596
32,0,0,10,"Hill","45-49 Yrs.",606140,285221,320919
32,0,0,11,"Hill","50-54 Yrs.",616255,297508,318747
32,0,0,12,"Hill","55-59 Yrs.",471446,230271,241175
32,0,0,13,"Hill","60-64 Yrs.",421649,203753,217896
32,0,0,14,"Hill","65-69 Yrs.",324575,155954,168621
32,0,0,15,"Hill","70-74 Yrs.",250619,115427,135192
32,0,0,16,"Hill","75-79 Yrs.",162522,74768,87754
32,0,0,17,"Hill","80-84 Yrs.",81090,38452,42638
32,0,0,18,"Hill","85-89 Yrs.",40124,18436,21688
32,0,0,19,"Hill","90-94 Yrs.",15097,6388,8709
32,0,0,20,"Hill","95+ Yrs.",7290,2713,4577
33,0,0,0,"Tarai","All Ages",15634006,7662044,7971962
33,0,0,1,"Tarai","00-04 Yrs.",1406799,746834,659965
33,0,0,2,"Tarai","05-09 Yrs.",1584803,828270,756533
33,0,0,3,"Tarai","10-14 Yrs.",1603666,826804,776862
33,0,0,4,"Tarai","15-19 Yrs.",1594973,809718,785255
33,0,0,5,"Tarai","20-24 Yrs.",1488293,688640,799653
33,0,0,6,"Tarai","25-29 Yrs.",1311993,586159,725834
33,0,0,7,"Tarai","30-34 Yrs.",1136360,506165,630195
33,0,0,8,"Tarai","35-39 Yrs.",1108104,501233,606871
33,0,0,9,"Tarai","40-44 Yrs.",925322,445761,479561
33,0,0,10,"Tarai","45-49 Yrs.",747041,362508,384533
33,0,0,11,"Tarai","50-54 Yrs.",712217,353263,358954
33,0,0,12,"Tarai","55-59 Yrs.",536136,272977,263159
33,0,0,13,"Tarai","60-64 Yrs.",470272,230938,239334
33,0,0,14,"Tarai","65-69 Yrs.",398138,199456,198682
33,0,0,15,"Tarai","70-74 Yrs.",318398,157852,160546
33,0,0,16,"Tarai","75-79 Yrs.",166999,85135,81864
33,0,0,17,"Tarai","80-84 Yrs.",68994,34390,34604
33,0,0,18,"Tarai","85-89 Yrs.",31138,15389,15749
33,0,0,19,"Tarai","90-94 Yrs.",13450,6087,7363
33,0,0,20,"Tarai","95+ Yrs.",10910,4465,6445
40,1,0,0,"Province-1","All Ages",4961412,2417328,2544084
40,1,0,1,"Province-1","00-04 Yrs.",382972,198619,184353
40,1,0,2,"Province-1","05-09 Yrs.",451346,231574,219772
40,1,0,3,"Province-1","10-14 Yrs.",455058,231545,223513
40,1,0,4,"Province-1","15-19 Yrs.",481880,242715,239165
40,1,0,5,"Province-1","20-24 Yrs.",451234,210760,240474
40,1,0,6,"Province-1","25-29 Yrs.",414446,188651,225795
40,1,0,7,"Province-1","30-34 Yrs.",368650,168852,199798
40,1,0,8,"Province-1","35-39 Yrs.",355201,164216,190985
40,1,0,9,"Province-1","40-44 Yrs.",313769,149827,163942
40,1,0,10,"Province-1","45-49 Yrs.",258216,124887,133329
40,1,0,11,"Province-1","50-54 Yrs.",265648,130429,135219
40,1,0,12,"Province-1","55-59 Yrs.",206528,102458,104070
40,1,0,13,"Province-1","60-64 Yrs.",183593,90215,93378
40,1,0,14,"Province-1","65-69 Yrs.",144070,71011,73059
40,1,0,15,"Province-1","70-74 Yrs.",107228,52509,54719
40,1,0,16,"Province-1","75-79 Yrs.",64506,31480,33026
40,1,0,17,"Province-1","80-84 Yrs.",31939,16083,15856
40,1,0,18,"Province-1","85-89 Yrs.",16534,7842,8692
40,1,0,19,"Province-1","90-94 Yrs.",5756,2587,3169
40,1,0,20,"Province-1","95+ Yrs.",2838,1068,1770
40,2,0,0,"Madhesh","All Ages",6114600,3065751,3048849
40,2,0,1,"Madhesh","00-04 Yrs.",641122,343350,297772
40,2,0,2,"Madhesh","05-09 Yrs.",703465,367293,336172
40,2,0,3,"Madhesh","10-14 Yrs.",683655,352252,331403
40,2,0,4,"Madhesh","15-19 Yrs.",628716,327285,301431
40,2,0,5,"Madhesh","20-24 Yrs.",568137,270626,297511
40,2,0,6,"Madhesh","25-29 Yrs.",480982,222693,258289
40,2,0,7,"Madhesh","30-34 Yrs.",402234,183710,218524
40,2,0,8,"Madhesh","35-39 Yrs.",405662,184460,221202
40,2,0,9,"Madhesh","40-44 Yrs.",325657,162490,163167
40,2,0,10,"Madhesh","45-49 Yrs.",272956,133759,139197
40,2,0,11,"Madhesh","50-54 Yrs.",250054,128977,121077
40,2,0,12,"Madhesh","55-59 Yrs.",192853,101572,91281
40,2,0,13,"Madhesh","60-64 Yrs.",173483,87346,86137
40,2,0,14,"Madhesh","65-69 Yrs.",155640,80973,74667
40,2,0,15,"Madhesh","70-74 Yrs.",129392,66137,63255
40,2,0,16,"Madhesh","75-79 Yrs.",61647,33110,28537
40,2,0,17,"Madhesh","80-84 Yrs.",21453,11136,10317
40,2,0,18,"Madhesh","85-89 Yrs.",8681,4544,4137
40,2,0,19,"Madhesh","90-94 Yrs.",4112,1971,2141
40,2,0,20,"Madhesh","95+ Yrs.",4699,2067,2632
40,3,0,0,"Bagmati","All Ages",6116866,3048684,3068182
40,3,0,1,"Bagmati","00-04 Yrs.",398478,211343,187135
40,3,0,2,"Bagmati","05-09 Yrs.",457697,242253,215444
40,3,0,3,"Bagmati","10-14 Yrs.",497539,259593,237946
40,3,0,4,"Bagmati","15-19 Yrs.",583970,301870,282100
40,3,0,5,"Bagmati","20-24 Yrs.",610209,302751,307458
40,3,0,6,"Bagmati","25-29 Yrs.",571993,275104,296889
40,3,0,7,"Bagmati","30-34 Yrs.",516535,247202,269333
40,3,0,8,"Bagmati","35-39 Yrs.",479801,230882,248919
40,3,0,9,"Bagmati","40-44 Yrs.",423815,205375,218440
40,3,0,10,"Bagmati","45-49 Yrs.",341815,167748,174067
40,3,0,11,"Bagmati","50-54 Yrs.",336416,168504,167912
40,3,0,12,"Bagmati","55-59 Yrs.",244749,123202,121547
40,3,0,13,"Bagmati","60-64 Yrs.",212098,104661,107437
40,3,0,14,"Bagmati","65-69 Yrs.",160866,78818,82048
40,3,0,15,"Bagmati","70-74 Yrs.",119931,56246,63685
40,3,0,16,"Bagmati","75-79 Yrs.",82345,38017,44328
40,3,0,17,"Bagmati","80-84 Yrs.",42456,19553,22903
40,3,0,18,"Bagmati","85-89 Yrs.",23496,10431,13065
40,3,0,19,"Bagmati","90-94 Yrs.",8574,3602,4972
40,3,0,20,"Bagmati","95+ Yrs.",4083,1529,2554
40,4,0,0,"Gandaki","All Ages",2466427,1170833,1295594
40,4,0,1,"Gandaki","00-04 Yrs.",168930,90109,78821
40,4,0,2,"Gandaki","05-09 Yrs.",202023,107325,94698
40,4,0,3,"Gandaki","10-14 Yrs.",217815,112774,105041
40,4,0,4,"Gandaki","15-19 Yrs.",236245,119627,116618
40,4,0,5,"Gandaki","20-24 Yrs.",224870,104438,120432
40,4,0,6,"Gandaki","25-29 Yrs.",205009,88570,116439
40,4,0,7,"Gandaki","30-34 Yrs.",183622,79759,103863
40,4,0,8,"Gandaki","35-39 Yrs.",171335,74724,96611
40,4,0,9,"Gandaki","40-44 Yrs.",152433,66888,85545
40,4,0,10,"Gandaki","45-49 Yrs.",129993,58568,71425
40,4,0,11,"Gandaki","50-54 Yrs.",135065,62964,72101
40,4,0,12,"Gandaki","55-59 Yrs.",109980,51726,58254
40,4,0,13,"Gandaki","60-64 Yrs.",102190,47867,54323
40,4,0,14,"Gandaki","65-69 Yrs.",82040,38318,43722
40,4,0,15,"Gandaki","70-74 Yrs.",63625,29097,34528
40,4,0,16,"Gandaki","75-79 Yrs.",41393,19216,22177
40,4,0,17,"Gandaki","80-84 Yrs.",22787,11044,11743
40,4,0,18,"Gandaki","85-89 Yrs.",10426,4971,5455
40,4,0,19,"Gandaki","90-94 Yrs.",4309,1907,2402
40,4,0,20,"Gandaki","95+ Yrs.",2337,941,1396
40,5,0,0,"Lumbini","All Ages",5122078,2454408,2667670
40,5,0,1,"Lumbini","00-04 Yrs.",439841,230778,209063
40,5,0,2,"Lumbini","05-09 Yrs.",497938,259850,238088
40,5,0,3,"Lumbini","10-14 Yrs.",523078,268902,254176
40,5,0,4,"Lumbini","15-19 Yrs.",540900,266043,274857
40,5,0,5,"Lumbini","20-24 Yrs.",496646,222525,274121
40,5,0,6,"Lumbini","25-29 Yrs.",440485,191156,249329
40,5,0,7,"Lumbini","30-34 Yrs.",381940,166688,215252
40,5,0,8,"Lumbini","35-39 Yrs.",357093,159440,197653
40,5,0,9,"Lumbini","40-44 Yrs.",298968,137684,161284
40,5,0,10,"Lumbini","45-49 Yrs.",239701,112978,126723
40,5,0,11,"Lumbini","50-54 Yrs.",236367,111759,124608
40,5,0,12,"Lumbini","55-59 Yrs.",179360,88491,90869
40,5,0,13,"Lumbini","60-64 Yrs.",158359,76171,82188
40,5,0,14,"Lumbini","65-69 Yrs.",130920,63584,67336
40,5,0,15,"Lumbini","70-74 Yrs.",102466,49769,52697
40,5,0,16,"Lumbini","75-79 Yrs.",56426,28123,28303
40,5,0,17,"Lumbini","80-84 Yrs.",24157,12144,12013
40,5,0,18,"Lumbini","85-89 Yrs.",10093,5111,4982
40,5,0,19,"Lumbini","90-94 Yrs.",4294,1967,2327
40,5,0,20,"Lumbini","95+ Yrs.",3046,1245,1801
40,6,0,0,"Karnali","All Ages",1688412,823761,864651
40,6,0,1,"Karnali","00-04 Yrs.",168801,88558,80243
40,6,0,2,"Karnali","05-09 Yrs.",181718,93345,88373
40,6,0,3,"Karnali","10-14 Yrs.",208372,105671,102701
40,6,0,4,"Karnali","15-19 Yrs.",196744,95552,101192
40,6,0,5,"Karnali","20-24 Yrs.",171261,78794,92467
40,6,0,6,"Karnali","25-29 Yrs.",133332,62847,70485
40,6,0,7,"Karnali","30-34 Yrs.",110629,51760,58869
40,6,0,8,"Karnali","35-39 Yrs.",100490,46602,53888
40,6,0,9,"Karnali","40-44 Yrs.",86139,39691,46448
40,6,0,10,"Karnali","45-49 Yrs.",73055,34930,38125
40,6,0,11,"Karnali","50-54 Yrs.",69706,34094,35612
40,6,0,12,"Karnali","55-59 Yrs.",53683,27094,26589
40,6,0,13,"Karnali","60-64 Yrs.",47987,23430,24557
40,6,0,14,"Karnali","65-69 Yrs.",34780,17196,17584
40,6,0,15,"Karnali","70-74 Yrs.",28770,13352,15418
40,6,0,16,"Karnali","75-79 Yrs.",14453,6790,7663
40,6,0,17,"Karnali","80-84 Yrs.",5250,2605,2645
40,6,0,18,"Karnali","85-89 Yrs.",1966,973,993
40,6,0,19,"Karnali","90-94 Yrs.",742,283,459
40,6,0,20,"Karnali","95+ Yrs.",534,194,340
40,7,0,0,"Sudur Paschim","All Ages",2694783,1272786,1421997
40,7,0,1,"Sudur Paschim","00-04 Yrs.",239139,127768,111371
40,7,0,2,"Sudur Paschim","05-09 Yrs.",272240,141765,130475
40,7,0,3,"Sudur Paschim","10-14 Yrs.",324348,165217,159131
40,7,0,4,"Sudur Paschim","15-19 Yrs.",297949,141431,156518
40,7,0,5,"Sudur Paschim","20-24 Yrs.",260703,111125,149578
40,7,0,6,"Sudur Paschim","25-29 Yrs.",213102,93221,119881
40,7,0,7,"Sudur Paschim","30-34 Yrs.",184102,81005,103097
40,7,0,8,"Sudur Paschim","35-39 Yrs.",171910,76607,95303
40,7,0,9,"Sudur Paschim","40-44 Yrs.",147051,66538,80513
40,7,0,10,"Sudur Paschim","45-49 Yrs.",120303,54654,65649
40,7,0,11,"Sudur Paschim","50-54 Yrs.",120595,55767,64828
40,7,0,12,"Sudur Paschim","55-59 Yrs.",88791,43015,45776
40,7,0,13,"Sudur Paschim","60-64 Yrs.",77894,36272,41622
40,7,0,14,"Sudur Paschim","65-69 Yrs.",63302,29789,33513
40,7,0,15,"Sudur Paschim","70-74 Yrs.",57958,24944,33014
40,7,0,16,"Sudur Paschim","75-79 Yrs.",32433,14262,18171
40,7,0,17,"Sudur Paschim","80-84 Yrs.",13514,5750,7764
40,7,0,18,"Sudur Paschim","85-89 Yrs.",5231,2295,2936
40,7,0,19,"Sudur Paschim","90-94 Yrs.",2619,874,1745
40,7,0,20,"Sudur Paschim","95+ Yrs.",1599,487,1112
50,1,1,0,"Taplejung","All Ages",120590,60773,59817
50,1,1,1,"Taplejung","00-04 Yrs.",10220,5243,4977
50,1,1,2,"Taplejung","05-09 Yrs.",11716,5940,5776
50,1,1,3,"Taplejung","10-14 Yrs.",11593,5745,5848
50,1,1,4,"Taplejung","15-19 Yrs.",13080,6543,6537
50,1,1,5,"Taplejung","20-24 Yrs.",11921,5989,5932
50,1,1,6,"Taplejung","25-29 Yrs.",10523,5441,5082
50,1,1,7,"Taplejung","30-34 Yrs.",8365,4263,4102
50,1,1,8,"Taplejung","35-39 Yrs.",7206,3606,3600
50,1,1,9,"Taplejung","40-44 Yrs.",6468,3191,3277
50,1,1,10,"Taplejung","45-49 Yrs.",5473,2626,2847
50,1,1,11,"Taplejung","50-54 Yrs.",6200,3146,3054
50,1,1,12,"Taplejung","55-59 Yrs.",4984,2489,2495
50,1,1,13,"Taplejung","60-64 Yrs.",4388,2311,2077
50,1,1,14,"Taplejung","65-69 Yrs.",3240,1624,1616
50,1,1,15,"Taplejung","70-74 Yrs.",2441,1226,1215
50,1,1,16,"Taplejung","75-79 Yrs.",1448,727,721
50,1,1,17,"Taplejung","80-84 Yrs.",802,415,387
50,1,1,18,"Taplejung","85-89 Yrs.",364,174,190
50,1,1,19,"Taplejung","90-94 Yrs.",121,54,67
50,1,1,20,"Taplejung","95+ Yrs.",37,20,17
50,1,2,0,"Sankhuwasabha","All Ages",158041,79579,78462
50,1,2,1,"Sankhuwasabha","00-04 Yrs.",11936,6199,5737
50,1,2,2,"Sankhuwasabha","05-09 Yrs.",15239,7883,7356
50,1,2,3,"Sankhuwasabha","10-14 Yrs.",15520,7869,7651
50,1,2,4,"Sankhuwasabha","15-19 Yrs.",15912,8063,7849
50,1,2,5,"Sankhuwasabha","20-24 Yrs.",13874,6830,7044
50,1,2,6,"Sankhuwasabha","25-29 Yrs.",13227,6708,6519
50,1,2,7,"Sankhuwasabha","30-34 Yrs.",11484,5884,5600
50,1,2,8,"Sankhuwasabha","35-39 Yrs.",10531,5313,5218
50,1,2,9,"Sankhuwasabha","40-44 Yrs.",9151,4566,4585
50,1,2,10,"Sankhuwasabha","45-49 Yrs.",7474,3710,3764
50,1,2,11,"Sankhuwasabha","50-54 Yrs.",7995,4031,3964
50,1,2,12,"Sankhuwasabha","55-59 Yrs.",6507,3188,3319
50,1,2,13,"Sankhuwasabha","60-64 Yrs.",6475,3163,3312
50,1,2,14,"Sankhuwasabha","65-69 Yrs.",4909,2437,2472
50,1,2,15,"Sankhuwasabha","70-74 Yrs.",3612,1746,1866
50,1,2,16,"Sankhuwasabha","75-79 Yrs.",2195,1034,1161
50,1,2,17,"Sankhuwasabha","80-84 Yrs.",1134,567,567
50,1,2,18,"Sankhuwasabha","85-89 Yrs.",605,284,321
50,1,2,19,"Sankhuwasabha","90-94 Yrs.",187,85,102
50,1,2,20,"Sankhuwasabha","95+ Yrs.",74,19,55
50,1,3,0,"Solukhumbu","All Ages",104851,52747,52104
50,1,3,1,"Solukhumbu","00-04 Yrs.",8323,4306,4017
50,1,3,2,"Solukhumbu","05-09 Yrs.",9365,4820,4545
50,1,3,3,"Solukhumbu","10-14 Yrs.",10373,5202,5171
50,1,3,4,"Solukhumbu","15-19 Yrs.",10461,5348,5113
50,1,3,5,"Solukhumbu","20-24 Yrs.",9747,4900,4847
50,1,3,6,"Solukhumbu","25-29 Yrs.",8872,4627,4245
50,1,3,7,"Solukhumbu","30-34 Yrs.",7451,3802,3649
50,1,3,8,"Solukhumbu","35-39 Yrs.",6811,3421,3390
50,1,3,9,"Solukhumbu","40-44 Yrs.",5786,2816,2970
50,1,3,10,"Solukhumbu","45-49 Yrs.",4752,2294,2458
50,1,3,11,"Solukhumbu","50-54 Yrs.",5727,2803,2924
50,1,3,12,"Solukhumbu","55-59 Yrs.",4483,2187,2296
50,1,3,13,"Solukhumbu","60-64 Yrs.",4091,2034,2057
50,1,3,14,"Solukhumbu","65-69 Yrs.",3206,1615,1591
50,1,3,15,"Solukhumbu","70-74 Yrs.",2443,1148,1295
50,1,3,16,"Solukhumbu","75-79 Yrs.",1650,801,849
50,1,3,17,"Solukhumbu","80-84 Yrs.",761,382,379
50,1,3,18,"Solukhumbu","85-89 Yrs.",410,186,224
50,1,3,19,"Solukhumbu","90-94 Yrs.",101,37,64
50,1,3,20,"Solukhumbu","95+ Yrs.",38,18,20
50,1,4,0,"Okhaldhunga","All Ages",139552,68080,71472
50,1,4,1,"Okhaldhunga","00-04 Yrs.",9959,5126,4833
50,1,4,2,"Okhaldhunga","05-09 Yrs.",11457,5689,5768
50,1,4,3,"Okhaldhunga","10-14 Yrs.",13436,6854,6582
50,1,4,4,"Okhaldhunga","15-19 Yrs.",14767,7319,7448
50,1,4,5,"Okhaldhunga","20-24 Yrs.",12841,6225,6616
50,1,4,6,"Okhaldhunga","25-29 Yrs.",11030,5385,5645
50,1,4,7,"Okhaldhunga","30-34 Yrs.",8974,4369,4605
50,1,4,8,"Okhaldhunga","35-39 Yrs.",8171,3856,4315
50,1,4,9,"Okhaldhunga","40-44 Yrs.",7533,3491,4042
50,1,4,10,"Okhaldhunga","45-49 Yrs.",6791,3160,3631
50,1,4,11,"Okhaldhunga","50-54 Yrs.",8332,4045,4287
50,1,4,12,"Okhaldhunga","55-59 Yrs.",6504,3167,3337
50,1,4,13,"Okhaldhunga","60-64 Yrs.",6111,2947,3164
50,1,4,14,"Okhaldhunga","65-69 Yrs.",4717,2237,2480
50,1,4,15,"Okhaldhunga","70-74 Yrs.",3838,1815,2023
50,1,4,16,"Okhaldhunga","75-79 Yrs.",2596,1216,1380
50,1,4,17,"Okhaldhunga","80-84 Yrs.",1400,685,715
50,1,4,18,"Okhaldhunga","85-89 Yrs.",708,324,384
50,1,4,19,"Okhaldhunga","90-94 Yrs.",268,123,145
50,1,4,20,"Okhaldhunga","95+ Yrs.",119,47,72
50,1,5,0,"Khotang","All Ages",175298,86637,88661
50,1,5,1,"Khotang","00-04 Yrs.",14416,7441,6975
50,1,5,2,"Khotang","05-09 Yrs.",16554,8349,8205
50,1,5,3,"Khotang","10-14 Yrs.",18027,8975,9052
50,1,5,4,"Khotang","15-19 Yrs.",19174,9581,9593
50,1,5,5,"Khotang","20-24 Yrs.",15690,7649,8041
50,1,5,6,"Khotang","25-29 Yrs.",13367,6660,6707
50,1,5,7,"Khotang","30-34 Yrs.",10595,5367,5228
50,1,5,8,"Khotang","35-39 Yrs.",9623,4661,4962
50,1,5,9,"Khotang","40-44 Yrs.",8659,4080,4579
50,1,5,10,"Khotang","45-49 Yrs.",8009,3734,4275
50,1,5,11,"Khotang","50-54 Yrs.",9690,4606,5084
50,1,5,12,"Khotang","55-59 Yrs.",8130,3942,4188
50,1,5,13,"Khotang","60-64 Yrs.",7334,3642,3692
50,1,5,14,"Khotang","65-69 Yrs.",5665,2820,2845
50,1,5,15,"Khotang","70-74 Yrs.",4518,2207,2311
50,1,5,16,"Khotang","75-79 Yrs.",3192,1491,1701
50,1,5,17,"Khotang","80-84 Yrs.",1536,865,671
50,1,5,18,"Khotang","85-89 Yrs.",791,408,383
50,1,5,19,"Khotang","90-94 Yrs.",252,125,127
50,1,5,20,"Khotang","95+ Yrs.",76,34,42
50,1,6,0,"Bhojpur","All Ages",157923,78211,79712
50,1,6,1,"Bhojpur","00-04 Yrs.",12228,6302,5926
50,1,6,2,"Bhojpur","05-09 Yrs.",14440,7212,7228
50,1,6,3,"Bhojpur","10-14 Yrs.",15601,7865,7736
50,1,6,4,"Bhojpur","15-19 Yrs.",16101,8178,7923
50,1,6,5,"Bhojpur","20-24 Yrs.",13679,6640,7039
50,1,6,6,"Bhojpur","25-29 Yrs.",12388,6290,6098
50,1,6,7,"Bhojpur","30-34 Yrs.",10409,5210,5199
50,1,6,8,"Bhojpur","35-39 Yrs.",9452,4611,4841
50,1,6,9,"Bhojpur","40-44 Yrs.",8496,4007,4489
50,1,6,10,"Bhojpur","45-49 Yrs.",7783,3744,4039
50,1,6,11,"Bhojpur","50-54 Yrs.",8857,4236,4621
50,1,6,12,"Bhojpur","55-59 Yrs.",7583,3686,3897
50,1,6,13,"Bhojpur","60-64 Yrs.",6908,3405,3503
50,1,6,14,"Bhojpur","65-69 Yrs.",4991,2426,2565
50,1,6,15,"Bhojpur","70-74 Yrs.",3934,1872,2062
50,1,6,16,"Bhojpur","75-79 Yrs.",2616,1336,1280
50,1,6,17,"Bhojpur","80-84 Yrs.",1349,676,673
50,1,6,18,"Bhojpur","85-89 Yrs.",783,381,402
50,1,6,19,"Bhojpur","90-94 Yrs.",237,104,133
50,1,6,20,"Bhojpur","95+ Yrs.",88,30,58
50,1,7,0,"Dhankuta","All Ages",150599,73824,76775
50,1,7,1,"Dhankuta","00-04 Yrs.",10706,5499,5207
50,1,7,2,"Dhankuta","05-09 Yrs.",12826,6608,6218
50,1,7,3,"Dhankuta","10-14 Yrs.",13324,6758,6566
50,1,7,4,"Dhankuta","15-19 Yrs.",14346,7172,7174
50,1,7,5,"Dhankuta","20-24 Yrs.",13496,6505,6991
50,1,7,6,"Dhankuta","25-29 Yrs.",12248,5959,6289
50,1,7,7,"Dhankuta","30-34 Yrs.",10877,5158,5719
50,1,7,8,"Dhankuta","35-39 Yrs.",10309,4993,5316
50,1,7,9,"Dhankuta","40-44 Yrs.",9324,4277,5047
50,1,7,10,"Dhankuta","45-49 Yrs.",8054,3795,4259
50,1,7,11,"Dhankuta","50-54 Yrs.",8720,4242,4478
50,1,7,12,"Dhankuta","55-59 Yrs.",7249,3449,3800
50,1,7,13,"Dhankuta","60-64 Yrs.",6402,3194,3208
50,1,7,14,"Dhankuta","65-69 Yrs.",4912,2391,2521
50,1,7,15,"Dhankuta","70-74 Yrs.",3454,1735,1719
50,1,7,16,"Dhankuta","75-79 Yrs.",2288,1088,1200
50,1,7,17,"Dhankuta","80-84 Yrs.",1219,622,597
50,1,7,18,"Dhankuta","85-89 Yrs.",581,258,323
50,1,7,19,"Dhankuta","90-94 Yrs.",197,92,105
50,1,7,20,"Dhankuta","95+ Yrs.",67,29,38
50,1,8,0,"Terhathum","All Ages",88731,43581,45150
50,1,8,1,"Terhathum","00-04 Yrs.",6749,3535,3214
50,1,8,2,"Terhathum","05-09 Yrs.",8127,4086,4041
50,1,8,3,"Terhathum","10-14 Yrs.",7850,3975,3875
50,1,8,4,"Terhathum","15-19 Yrs.",8880,4551,4329
50,1,8,5,"Terhathum","20-24 Yrs.",8018,3814,4204
50,1,8,6,"Terhathum","25-29 Yrs.",7065,3380,3685
50,1,8,7,"Terhathum","30-34 Yrs.",6275,3082,3193
50,1,8,8,"Terhathum","35-39 Yrs.",5706,2771,2935
50,1,8,9,"Terhathum","40-44 Yrs.",5093,2415,2678
50,1,8,10,"Terhathum","45-49 Yrs.",4383,1966,2417
50,1,8,11,"Terhathum","50-54 Yrs.",5095,2450,2645
50,1,8,12,"Terhathum","55-59 Yrs.",4131,1987,2144
50,1,8,13,"Terhathum","60-64 Yrs.",3906,1981,1925
50,1,8,14,"Terhathum","65-69 Yrs.",2770,1341,1429
50,1,8,15,"Terhathum","70-74 Yrs.",2052,969,1083
50,1,8,16,"Terhathum","75-79 Yrs.",1352,647,705
50,1,8,17,"Terhathum","80-84 Yrs.",744,381,363
50,1,8,18,"Terhathum","85-89 Yrs.",368,177,191
50,1,8,19,"Terhathum","90-94 Yrs.",124,55,69
50,1,8,20,"Terhathum","95+ Yrs.",43,18,25
50,1,9,0,"Panchthar","All Ages",172400,85683,86717
50,1,9,1,"Panchthar","00-04 Yrs.",13976,7131,6845
50,1,9,2,"Panchthar","05-09 Yrs.",15799,7994,7805
50,1,9,3,"Panchthar","10-14 Yrs.",15549,7766,7783
50,1,9,4,"Panchthar","15-19 Yrs.",17649,8987,8662
50,1,9,5,"Panchthar","20-24 Yrs.",16413,8107,8306
50,1,9,6,"Panchthar","25-29 Yrs.",14719,7313,7406
50,1,9,7,"Panchthar","30-34 Yrs.",12303,6159,6144
50,1,9,8,"Panchthar","35-39 Yrs.",10929,5328,5601
50,1,9,9,"Panchthar","40-44 Yrs.",9345,4429,4916
50,1,9,10,"Panchthar","45-49 Yrs.",8089,3772,4317
50,1,9,11,"Panchthar","50-54 Yrs.",9404,4514,4890
50,1,9,12,"Panchthar","55-59 Yrs.",7978,3944,4034
50,1,9,13,"Panchthar","60-64 Yrs.",7097,3570,3527
50,1,9,14,"Panchthar","65-69 Yrs.",5170,2644,2526
50,1,9,15,"Panchthar","70-74 Yrs.",3557,1765,1792
50,1,9,16,"Panchthar","75-79 Yrs.",2291,1136,1155
50,1,9,17,"Panchthar","80-84 Yrs.",1297,701,596
50,1,9,18,"Panchthar","85-89 Yrs.",587,300,287
50,1,9,19,"Panchthar","90-94 Yrs.",192,97,95
50,1,9,20,"Panchthar","95+ Yrs.",56,26,30
50,1,10,0,"Ilam","All Ages",279534,139431,140103
50,1,10,1,"Ilam","00-04 Yrs.",18042,9239,8803
50,1,10,2,"Ilam","05-09 Yrs.",21314,10984,10330
50,1,10,3,"Ilam","10-14 Yrs.",21305,10869,10436
50,1,10,4,"Ilam","15-19 Yrs.",25856,12978,12878
50,1,10,5,"Ilam","20-24 Yrs.",25018,12057,12961
50,1,10,6,"Ilam","25-29 Yrs.",24637,11852,12785
50,1,10,7,"Ilam","30-34 Yrs.",22466,11251,11215
50,1,10,8,"Ilam","35-39 Yrs.",20841,10134,10707
50,1,10,9,"Ilam","40-44 Yrs.",18789,8974,9815
50,1,10,10,"Ilam","45-49 Yrs.",15155,7294,7861
50,1,10,11,"Ilam","50-54 Yrs.",16702,8242,8460
50,1,10,12,"Ilam","55-59 Yrs.",13550,6778,6772
50,1,10,13,"Ilam","60-64 Yrs.",12162,6369,5793
50,1,10,14,"Ilam","65-69 Yrs.",9569,4908,4661
50,1,10,15,"Ilam","70-74 Yrs.",6550,3429,3121
50,1,10,16,"Ilam","75-79 Yrs.",4162,2188,1974
50,1,10,17,"Ilam","80-84 Yrs.",2012,1157,855
50,1,10,18,"Ilam","85-89 Yrs.",1010,512,498
50,1,10,19,"Ilam","90-94 Yrs.",291,163,128
50,1,10,20,"Ilam","95+ Yrs.",103,53,50
50,1,11,0,"Jhapa","All Ages",998054,478509,519545
50,1,11,1,"Jhapa","00-04 Yrs.",73039,38008,35031
50,1,11,2,"Jhapa","05-09 Yrs.",88273,45765,42508
50,1,11,3,"Jhapa","10-14 Yrs.",88726,45313,43413
50,1,11,4,"Jhapa","15-19 Yrs.",93311,46445,46866
50,1,11,5,"Jhapa","20-24 Yrs.",85420,38644,46776
50,1,11,6,"Jhapa","25-29 Yrs.",80245,33984,46261
50,1,11,7,"Jhapa","30-34 Yrs.",76793,32879,43914
50,1,11,8,"Jhapa","35-39 Yrs.",76496,34172,42324
50,1,11,9,"Jhapa","40-44 Yrs.",69996,33210,36786
50,1,11,10,"Jhapa","45-49 Yrs.",55853,27116,28737
50,1,11,11,"Jhapa","50-54 Yrs.",55422,27392,28030
50,1,11,12,"Jhapa","55-59 Yrs.",41388,20567,20821
50,1,11,13,"Jhapa","60-64 Yrs.",35887,17402,18485
50,1,11,14,"Jhapa","65-69 Yrs.",29092,14080,15012
50,1,11,15,"Jhapa","70-74 Yrs.",21960,10726,11234
50,1,11,16,"Jhapa","75-79 Yrs.",13531,6669,6862
50,1,11,17,"Jhapa","80-84 Yrs.",6994,3546,3448
50,1,11,18,"Jhapa","85-89 Yrs.",3762,1803,1959
50,1,11,19,"Jhapa","90-94 Yrs.",1261,564,697
50,1,11,20,"Jhapa","95+ Yrs.",605,224,381
50,1,12,0,"Morang","All Ages",1148156,557512,590644
50,1,12,1,"Morang","00-04 Yrs.",87621,45443,42178
50,1,12,2,"Morang","05-09 Yrs.",103894,53281,50613
50,1,12,3,"Morang","10-14 Yrs.",103670,53088,50582
50,1,12,4,"Morang","15-19 Yrs.",109068,55144,53924
50,1,12,5,"Morang","20-24 Yrs.",105176,48644,56532
50,1,12,6,"Morang","25-29 Yrs.",96679,42964,53715
50,1,12,7,"Morang","30-34 Yrs.",85924,38441,47483
50,1,12,8,"Morang","35-39 Yrs.",86977,39446,47531
50,1,12,9,"Morang","40-44 Yrs.",76377,36987,39390
50,1,12,10,"Morang","45-49 Yrs.",62064,30690,31374
50,1,12,11,"Morang","50-54 Yrs.",60191,29495,30696
50,1,12,12,"Morang","55-59 Yrs.",46806,23308,23498
50,1,12,13,"Morang","60-64 Yrs.",41290,20079,21211
50,1,12,14,"Morang","65-69 Yrs.",33051,16400,16651
50,1,12,15,"Morang","70-74 Yrs.",24282,12091,12191
50,1,12,16,"Morang","75-79 Yrs.",13325,6634,6691
50,1,12,17,"Morang","80-84 Yrs.",6405,3050,3355
50,1,12,18,"Morang","85-89 Yrs.",3306,1482,1824
50,1,12,19,"Morang","90-94 Yrs.",1307,576,731
50,1,12,20,"Morang","95+ Yrs.",743,269,474
50,1,13,0,"Sunsari","All Ages",926962,449023,477939
50,1,13,1,"Sunsari","00-04 Yrs.",78026,40763,37263
50,1,13,2,"Sunsari","05-09 Yrs.",89513,45983,43530
50,1,13,3,"Sunsari","10-14 Yrs.",85148,43703,41445
50,1,13,4,"Sunsari","15-19 Yrs.",87286,44440,42846
50,1,13,5,"Sunsari","20-24 Yrs.",88382,40308,48074
50,1,13,6,"Sunsari","25-29 Yrs.",81790,35937,45853
50,1,13,7,"Sunsari","30-34 Yrs.",72068,32089,39979
50,1,13,8,"Sunsari","35-39 Yrs.",69214,31463,37751
50,1,13,9,"Sunsari","40-44 Yrs.",59453,28603,30850
50,1,13,10,"Sunsari","45-49 Yrs.",47790,23125,24665
50,1,13,11,"Sunsari","50-54 Yrs.",45555,22611,22944
50,1,13,12,"Sunsari","55-59 Yrs.",34255,17347,16908
50,1,13,13,"Sunsari","60-64 Yrs.",30005,14589,15416
50,1,13,14,"Sunsari","65-69 Yrs.",23632,11630,12002
50,1,13,15,"Sunsari","70-74 Yrs.",17488,8441,9047
50,1,13,16,"Sunsari","75-79 Yrs.",9420,4376,5044
50,1,13,17,"Sunsari","80-84 Yrs.",4287,2018,2269
50,1,13,18,"Sunsari","85-89 Yrs.",2192,1019,1173
50,1,13,19,"Sunsari","90-94 Yrs.",845,359,486
50,1,13,20,"Sunsari","95+ Yrs.",613,219,394
50,1,14,0,"Udayapur","All Ages",340721,163738,176983
50,1,14,1,"Udayapur","00-04 Yrs.",27731,14384,13347
50,1,14,2,"Udayapur","05-09 Yrs.",32829,16980,15849
50,1,14,3,"Udayapur","10-14 Yrs.",34936,17563,17373
50,1,14,4,"Udayapur","15-19 Yrs.",35989,17966,18023
50,1,14,5,"Udayapur","20-24 Yrs.",31559,14448,17111
50,1,14,6,"Udayapur","25-29 Yrs.",27656,12151,15505
50,1,14,7,"Udayapur","30-34 Yrs.",24666,10898,13768
50,1,14,8,"Udayapur","35-39 Yrs.",22935,10441,12494
50,1,14,9,"Udayapur","40-44 Yrs.",19299,8781,10518
50,1,14,10,"Udayapur","45-49 Yrs.",16546,7861,8685
50,1,14,11,"Udayapur","50-54 Yrs.",17758,8616,9142
50,1,14,12,"Udayapur","55-59 Yrs.",12980,6419,6561
50,1,14,13,"Udayapur","60-64 Yrs.",11537,5529,6008
50,1,14,14,"Udayapur","65-69 Yrs.",9146,4458,4688
50,1,14,15,"Udayapur","70-74 Yrs.",7099,3339,3760
50,1,14,16,"Udayapur","75-79 Yrs.",4440,2137,2303
50,1,14,17,"Udayapur","80-84 Yrs.",1999,1018,981
50,1,14,18,"Udayapur","85-89 Yrs.",1067,534,533
50,1,14,19,"Udayapur","90-94 Yrs.",373,153,220
50,1,14,20,"Udayapur","95+ Yrs.",176,62,114
50,2,15,0,"Saptari","All Ages",706255,351368,354887
50,2,15,1,"Saptari","00-04 Yrs.",66904,36214,30690
50,2,15,2,"Saptari","05-09 Yrs.",72537,38083,34454
50,2,15,3,"Saptari","10-14 Yrs.",70936,36772,34164
50,2,15,4,"Saptari","15-19 Yrs.",69073,35758,33315
50,2,15,5,"Saptari","20-24 Yrs.",67128,31478,35650
50,2,15,6,"Saptari","25-29 Yrs.",57328,26538,30790
50,2,15,7,"Saptari","30-34 Yrs.",47913,21791,26122
50,2,15,8,"Saptari","35-39 Yrs.",49863,22485,27378
50,2,15,9,"Saptari","40-44 Yrs.",40017,19622,20395
50,2,15,10,"Saptari","45-49 Yrs.",33589,16562,17027
50,2,15,11,"Saptari","50-54 Yrs.",32246,16116,16130
50,2,15,12,"Saptari","55-59 Yrs.",25068,13193,11875
50,2,15,13,"Saptari","60-64 Yrs.",21863,10765,11098
50,2,15,14,"Saptari","65-69 Yrs.",20064,9988,10076
50,2,15,15,"Saptari","70-74 Yrs.",18081,8967,9114
50,2,15,16,"Saptari","75-79 Yrs.",8685,4602,4083
50,2,15,17,"Saptari","80-84 Yrs.",2686,1351,1335
50,2,15,18,"Saptari","85-89 Yrs.",1087,544,543
50,2,15,19,"Saptari","90-94 Yrs.",538,248,290
50,2,15,20,"Saptari","95+ Yrs.",649,291,358
50,2,16,0,"Siraha","All Ages",739953,363724,376229
50,2,16,1,"Siraha","00-04 Yrs.",79218,43549,35669
50,2,16,2,"Siraha","05-09 Yrs.",86044,46178,39866
50,2,16,3,"Siraha","10-14 Yrs.",79741,41763,37978
50,2,16,4,"Siraha","15-19 Yrs.",73212,37999,35213
50,2,16,5,"Siraha","20-24 Yrs.",68898,30807,38091
50,2,16,6,"Siraha","25-29 Yrs.",57633,24737,32896
50,2,16,7,"Siraha","30-34 Yrs.",47990,20275,27715
50,2,16,8,"Siraha","35-39 Yrs.",49280,20833,28447
50,2,16,9,"Siraha","40-44 Yrs.",38475,18165,20310
50,2,16,10,"Siraha","45-49 Yrs.",33033,15214,17819
50,2,16,11,"Siraha","50-54 Yrs.",30696,15348,15348
50,2,16,12,"Siraha","55-59 Yrs.",24743,12953,11790
50,2,16,13,"Siraha","60-64 Yrs.",22263,10935,11328
50,2,16,14,"Siraha","65-69 Yrs.",20286,10351,9935
50,2,16,15,"Siraha","70-74 Yrs.",16351,8352,7999
50,2,16,16,"Siraha","75-79 Yrs.",7243,3886,3357
50,2,16,17,"Siraha","80-84 Yrs.",2579,1270,1309
50,2,16,18,"Siraha","85-89 Yrs.",1050,570,480
50,2,16,19,"Siraha","90-94 Yrs.",573,248,325
50,2,16,20,"Siraha","95+ Yrs.",645,291,354
50,2,17,0,"Dhanusa","All Ages",867747,429893,437854
50,2,17,1,"Dhanusa","00-04 Yrs.",95737,53654,42083
50,2,17,2,"Dhanusa","05-09 Yrs.",99906,53349,46557
50,2,17,3,"Dhanusa","10-14 Yrs.",94329,49212,45117
50,2,17,4,"Dhanusa","15-19 Yrs.",85077,44415,40662
50,2,17,5,"Dhanusa","20-24 Yrs.",80749,35643,45106
50,2,17,6,"Dhanusa","25-29 Yrs.",69238,29703,39535
50,2,17,7,"Dhanusa","30-34 Yrs.",56271,24762,31509
50,2,17,8,"Dhanusa","35-39 Yrs.",56912,24264,32648
50,2,17,9,"Dhanusa","40-44 Yrs.",43562,20701,22861
50,2,17,10,"Dhanusa","45-49 Yrs.",37535,17175,20360
50,2,17,11,"Dhanusa","50-54 Yrs.",35208,17594,17614
50,2,17,12,"Dhanusa","55-59 Yrs.",28717,14875,13842
50,2,17,13,"Dhanusa","60-64 Yrs.",27275,13898,13377
50,2,17,14,"Dhanusa","65-69 Yrs.",24209,13054,11155
50,2,17,15,"Dhanusa","70-74 Yrs.",19379,10316,9063
50,2,17,16,"Dhanusa","75-79 Yrs.",8132,4504,3628
50,2,17,17,"Dhanusa","80-84 Yrs.",2992,1547,1445
50,2,17,18,"Dhanusa","85-89 Yrs.",1201,612,589
50,2,17,19,"Dhanusa","90-94 Yrs.",631,305,326
50,2,17,20,"Dhanusa","95+ Yrs.",687,310,377
50,2,18,0,"Mahottari","All Ages",706994,349159,357835
50,2,18,1,"Mahottari","00-04 Yrs.",75330,40219,35111
50,2,18,2,"Mahottari","05-09 Yrs.",83110,42744,40366
50,2,18,3,"Mahottari","10-14 Yrs.",82076,41931,40145
50,2,18,4,"Mahottari","15-19 Yrs.",73422,37865,35557
50,2,18,5,"Mahottari","20-24 Yrs.",63613,29689,33924
50,2,18,6,"Mahottari","25-29 Yrs.",54326,24016,30310
50,2,18,7,"Mahottari","30-34 Yrs.",45022,19666,25356
50,2,18,8,"Mahottari","35-39 Yrs.",45653,19543,26110
50,2,18,9,"Mahottari","40-44 Yrs.",36088,17343,18745
50,2,18,10,"Mahottari","45-49 Yrs.",30967,15014,15953
50,2,18,11,"Mahottari","50-54 Yrs.",28257,14231,14026
50,2,18,12,"Mahottari","55-59 Yrs.",22652,11844,10808
50,2,18,13,"Mahottari","60-64 Yrs.",21133,10852,10281
50,2,18,14,"Mahottari","65-69 Yrs.",19336,10310,9026
50,2,18,15,"Mahottari","70-74 Yrs.",15176,7971,7205
50,2,18,16,"Mahottari","75-79 Yrs.",6493,3659,2834
50,2,18,17,"Mahottari","80-84 Yrs.",2332,1252,1080
50,2,18,18,"Mahottari","85-89 Yrs.",957,511,446
50,2,18,19,"Mahottari","90-94 Yrs.",460,232,228
50,2,18,20,"Mahottari","95+ Yrs.",591,267,324
50,2,19,0,"Sarlahi","All Ages",862470,435131,427339
50,2,19,1,"Sarlahi","00-04 Yrs.",87060,45982,41078
50,2,19,2,"Sarlahi","05-09 Yrs.",97841,50713,47128
50,2,19,3,"Sarlahi","10-14 Yrs.",99039,50581,48458
50,2,19,4,"Sarlahi","15-19 Yrs.",91346,47547,43799
50,2,19,5,"Sarlahi","20-24 Yrs.",81782,40053,41729
50,2,19,6,"Sarlahi","25-29 Yrs.",68197,32558,35639
50,2,19,7,"Sarlahi","30-34 Yrs.",56400,26415,29985
50,2,19,8,"Sarlahi","35-39 Yrs.",56341,26097,30244
50,2,19,9,"Sarlahi","40-44 Yrs.",46801,23816,22985
50,2,19,10,"Sarlahi","45-49 Yrs.",38248,19091,19157
50,2,19,11,"Sarlahi","50-54 Yrs.",35021,18487,16534
50,2,19,12,"Sarlahi","55-59 Yrs.",26825,13990,12835
50,2,19,13,"Sarlahi","60-64 Yrs.",24455,12482,11973
50,2,19,14,"Sarlahi","65-69 Yrs.",20430,10665,9765
50,2,19,15,"Sarlahi","70-74 Yrs.",17745,8945,8800
50,2,19,16,"Sarlahi","75-79 Yrs.",9066,4730,4336
50,2,19,17,"Sarlahi","80-84 Yrs.",3257,1723,1534
50,2,19,18,"Sarlahi","85-89 Yrs.",1364,711,653
50,2,19,19,"Sarlahi","90-94 Yrs.",621,290,331
50,2,19,20,"Sarlahi","95+ Yrs.",631,255,376
50,2,20,0,"Rautahat","All Ages",813573,408403,405170
50,2,20,1,"Rautahat","00-04 Yrs.",97373,50068,47305
50,2,20,2,"Rautahat","05-09 Yrs.",104136,53073,51063
50,2,20,3,"Rautahat","10-14 Yrs.",97413,49547,47866
50,2,20,4,"Rautahat","15-19 Yrs.",85971,44172,41799
50,2,20,5,"Rautahat","20-24 Yrs.",75268,36893,38375
50,2,20,6,"Rautahat","25-29 Yrs.",60380,28954,31426
50,2,20,7,"Rautahat","30-34 Yrs.",49547,22971,26576
50,2,20,8,"Rautahat","35-39 Yrs.",49676,23207,26469
50,2,20,9,"Rautahat","40-44 Yrs.",41288,21092,20196
50,2,20,10,"Rautahat","45-49 Yrs.",33797,16876,16921
50,2,20,11,"Rautahat","50-54 Yrs.",30221,16085,14136
50,2,20,12,"Rautahat","55-59 Yrs.",22247,11988,10259
50,2,20,13,"Rautahat","60-64 Yrs.",19005,9500,9505
50,2,20,14,"Rautahat","65-69 Yrs.",17814,9033,8781
50,2,20,15,"Rautahat","70-74 Yrs.",15925,7923,8002
50,2,20,16,"Rautahat","75-79 Yrs.",8437,4491,3946
50,2,20,17,"Rautahat","80-84 Yrs.",2860,1515,1345
50,2,20,18,"Rautahat","85-89 Yrs.",1128,552,576
50,2,20,19,"Rautahat","90-94 Yrs.",494,239,255
50,2,20,20,"Rautahat","95+ Yrs.",593,224,369
50,2,21,0,"Bara","All Ages",763137,389787,373350
50,2,21,1,"Bara","00-04 Yrs.",77628,40910,36718
50,2,21,2,"Bara","05-09 Yrs.",86498,44938,41560
50,2,21,3,"Bara","10-14 Yrs.",85704,44152,41552
50,2,21,4,"Bara","15-19 Yrs.",80921,42407,38514
50,2,21,5,"Bara","20-24 Yrs.",71399,35731,35668
50,2,21,6,"Bara","25-29 Yrs.",61330,30151,31179
50,2,21,7,"Bara","30-34 Yrs.",52562,25139,27423
50,2,21,8,"Bara","35-39 Yrs.",51987,25120,26867
50,2,21,9,"Bara","40-44 Yrs.",42340,22123,20217
50,2,21,10,"Bara","45-49 Yrs.",34634,17570,17064
50,2,21,11,"Bara","50-54 Yrs.",31477,16742,14735
50,2,21,12,"Bara","55-59 Yrs.",22558,11956,10602
50,2,21,13,"Bara","60-64 Yrs.",19729,9857,9872
50,2,21,14,"Bara","65-69 Yrs.",17663,9205,8458
50,2,21,15,"Bara","70-74 Yrs.",14576,7373,7203
50,2,21,16,"Bara","75-79 Yrs.",7568,4015,3553
50,2,21,17,"Bara","80-84 Yrs.",2613,1375,1238
50,2,21,18,"Bara","85-89 Yrs.",1021,570,451
50,2,21,19,"Bara","90-94 Yrs.",442,222,220
50,2,21,20,"Bara","95+ Yrs.",487,231,256
50,2,22,0,"Parsa","All Ages",654471,338286,316185
50,2,22,1,"Parsa","00-04 Yrs.",61872,32754,29118
50,2,22,2,"Parsa","05-09 Yrs.",73393,38215,35178
50,2,22,3,"Parsa","10-14 Yrs.",74417,38294,36123
50,2,22,4,"Parsa","15-19 Yrs.",69694,37122,32572
50,2,22,5,"Parsa","20-24 Yrs.",59300,30332,28968
50,2,22,6,"Parsa","25-29 Yrs.",52550,26036,26514
50,2,22,7,"Parsa","30-34 Yrs.",46529,22691,23838
50,2,22,8,"Parsa","35-39 Yrs.",45950,22911,23039
50,2,22,9,"Parsa","40-44 Yrs.",37086,19628,17458
50,2,22,10,"Parsa","45-49 Yrs.",31153,16257,14896
50,2,22,11,"Parsa","50-54 Yrs.",26928,14374,12554
50,2,22,12,"Parsa","55-59 Yrs.",20043,10773,9270
50,2,22,13,"Parsa","60-64 Yrs.",17760,9057,8703
50,2,22,14,"Parsa","65-69 Yrs.",15838,8367,7471
50,2,22,15,"Parsa","70-74 Yrs.",12159,6290,5869
50,2,22,16,"Parsa","75-79 Yrs.",6023,3223,2800
50,2,22,17,"Parsa","80-84 Yrs.",2134,1103,1031
50,2,22,18,"Parsa","85-89 Yrs.",873,474,399
50,2,22,19,"Parsa","90-94 Yrs.",353,187,166
50,2,22,20,"Parsa","95+ Yrs.",416,198,218
50,3,23,0,"Dolakha","All Ages",172767,83720,89047
50,3,23,1,"Dolakha","00-04 Yrs.",11909,6215,5694
50,3,23,2,"Dolakha","05-09 Yrs.",13760,7004,6756
50,3,23,3,"Dolakha","10-14 Yrs.",15307,7633,7674
50,3,23,4,"Dolakha","15-19 Yrs.",16470,8090,8380
50,3,23,5,"Dolakha","20-24 Yrs.",14768,7160,7608
50,3,23,6,"Dolakha","25-29 Yrs.",13550,6634,6916
50,3,23,7,"Dolakha","30-34 Yrs.",11722,5720,6002
50,3,23,8,"Dolakha","35-39 Yrs.",10674,5071,5603
50,3,23,9,"Dolakha","40-44 Yrs.",9737,4509,5228
50,3,23,10,"Dolakha","45-49 Yrs.",8607,3904,4703
50,3,23,11,"Dolakha","50-54 Yrs.",10265,4704,5561
50,3,23,12,"Dolakha","55-59 Yrs.",8575,4066,4509
50,3,23,13,"Dolakha","60-64 Yrs.",8401,4081,4320
50,3,23,14,"Dolakha","65-69 Yrs.",6896,3314,3582
50,3,23,15,"Dolakha","70-74 Yrs.",5146,2420,2726
50,3,23,16,"Dolakha","75-79 Yrs.",3534,1664,1870
50,3,23,17,"Dolakha","80-84 Yrs.",1937,912,1025
50,3,23,18,"Dolakha","85-89 Yrs.",1011,454,557
50,3,23,19,"Dolakha","90-94 Yrs.",352,119,233
50,3,23,20,"Dolakha","95+ Yrs.",146,46,100
50,3,24,0,"Sindhupalchok","All Ages",262624,129205,133419
50,3,24,1,"Sindhupalchok","00-04 Yrs.",18866,9946,8920
50,3,24,2,"Sindhupalchok","05-09 Yrs.",21153,10695,10458
50,3,24,3,"Sindhupalchok","10-14 Yrs.",23418,11647,11771
50,3,24,4,"Sindhupalchok","15-19 Yrs.",24274,11875,12399
50,3,24,5,"Sindhupalchok","20-24 Yrs.",21523,10370,11153
50,3,24,6,"Sindhupalchok","25-29 Yrs.",20420,9977,10443
50,3,24,7,"Sindhupalchok","30-34 Yrs.",18019,8916,9103
50,3,24,8,"Sindhupalchok","35-39 Yrs.",17284,8235,9049
50,3,24,9,"Sindhupalchok","40-44 Yrs.",16274,7727,8547
50,3,24,10,"Sindhupalchok","45-49 Yrs.",14467,6895,7572
50,3,24,11,"Sindhupalchok","50-54 Yrs.",15713,7523,8190
50,3,24,12,"Sindhupalchok","55-59 Yrs.",12212,6156,6056
50,3,24,13,"Sindhupalchok","60-64 Yrs.",12014,5913,6101
50,3,24,14,"Sindhupalchok","65-69 Yrs.",9573,4927,4646
50,3,24,15,"Sindhupalchok","70-74 Yrs.",7853,3795,4058
50,3,24,16,"Sindhupalchok","75-79 Yrs.",4928,2431,2497
50,3,24,17,"Sindhupalchok","80-84 Yrs.",2724,1313,1411
50,3,24,18,"Sindhupalchok","85-89 Yrs.",1265,585,680
50,3,24,19,"Sindhupalchok","90-94 Yrs.",429,178,251
50,3,24,20,"Sindhupalchok","95+ Yrs.",215,101,114
50,3,25,0,"Rasuwa","All Ages",46689,24035,22654
50,3,25,1,"Rasuwa","00-04 Yrs.",3970,2012,1958
50,3,25,2,"Rasuwa","05-09 Yrs.",4025,2043,1982
50,3,25,3,"Rasuwa","10-14 Yrs.",4043,2015,2028
50,3,25,4,"Rasuwa","15-19 Yrs.",4328,2115,2213
50,3,25,5,"Rasuwa","20-24 Yrs.",4509,2403,2106
50,3,25,6,"Rasuwa","25-29 Yrs.",4108,2162,1946
50,3,25,7,"Rasuwa","30-34 Yrs.",3601,1913,1688
50,3,25,8,"Rasuwa","35-39 Yrs.",3253,1855,1398
50,3,25,9,"Rasuwa","40-44 Yrs.",2737,1383,1354
50,3,25,10,"Rasuwa","45-49 Yrs.",2367,1179,1188
50,3,25,11,"Rasuwa","50-54 Yrs.",2249,1102,1147
50,3,25,12,"Rasuwa","55-59 Yrs.",1744,901,843
50,3,25,13,"Rasuwa","60-64 Yrs.",1780,938,842
50,3,25,14,"Rasuwa","65-69 Yrs.",1477,760,717
50,3,25,15,"Rasuwa","70-74 Yrs.",1073,545,528
50,3,25,16,"Rasuwa","75-79 Yrs.",697,344,353
50,3,25,17,"Rasuwa","80-84 Yrs.",449,228,221
50,3,25,18,"Rasuwa","85-89 Yrs.",189,91,98
50,3,25,19,"Rasuwa","90-94 Yrs.",60,33,27
50,3,25,20,"Rasuwa","95+ Yrs.",30,13,17
50,3,26,0,"Dhading","All Ages",325710,159048,166662
50,3,26,1,"Dhading","00-04 Yrs.",24023,12531,11492
50,3,26,2,"Dhading","05-09 Yrs.",27548,14126,13422
50,3,26,3,"Dhading","10-14 Yrs.",31024,15777,15247
50,3,26,4,"Dhading","15-19 Yrs.",31856,15687,16169
50,3,26,5,"Dhading","20-24 Yrs.",28819,13561,15258
50,3,26,6,"Dhading","25-29 Yrs.",26558,12637,13921
50,3,26,7,"Dhading","30-34 Yrs.",22215,10400,11815
50,3,26,8,"Dhading","35-39 Yrs.",21800,10259,11541
50,3,26,9,"Dhading","40-44 Yrs.",18931,8857,10074
50,3,26,10,"Dhading","45-49 Yrs.",15687,7238,8449
50,3,26,11,"Dhading","50-54 Yrs.",17661,8543,9118
50,3,26,12,"Dhading","55-59 Yrs.",14015,6910,7105
50,3,26,13,"Dhading","60-64 Yrs.",13683,6787,6896
50,3,26,14,"Dhading","65-69 Yrs.",10984,5486,5498
50,3,26,15,"Dhading","70-74 Yrs.",8720,4211,4509
50,3,26,16,"Dhading","75-79 Yrs.",6180,3062,3118
50,3,26,17,"Dhading","80-84 Yrs.",3121,1595,1526
50,3,26,18,"Dhading","85-89 Yrs.",1786,874,912
50,3,26,19,"Dhading","90-94 Yrs.",728,349,379
50,3,26,20,"Dhading","95+ Yrs.",371,158,213
50,3,27,0,"Nuwakot","All Ages",263391,128998,134393
50,3,27,1,"Nuwakot","00-04 Yrs.",19008,9936,9072
50,3,27,2,"Nuwakot","05-09 Yrs.",21675,10969,10706
50,3,27,3,"Nuwakot","10-14 Yrs.",23677,11840,11837
50,3,27,4,"Nuwakot","15-19 Yrs.",23900,11717,12183
50,3,27,5,"Nuwakot","20-24 Yrs.",22973,11167,11806
50,3,27,6,"Nuwakot","25-29 Yrs.",21000,9894,11106
50,3,27,7,"Nuwakot","30-34 Yrs.",18565,8857,9708
50,3,27,8,"Nuwakot","35-39 Yrs.",17947,8621,9326
50,3,27,9,"Nuwakot","40-44 Yrs.",16219,7655,8564
50,3,27,10,"Nuwakot","45-49 Yrs.",13793,6485,7308
50,3,27,11,"Nuwakot","50-54 Yrs.",15183,7396,7787
50,3,27,12,"Nuwakot","55-59 Yrs.",11873,5866,6007
50,3,27,13,"Nuwakot","60-64 Yrs.",11835,5982,5853
50,3,27,14,"Nuwakot","65-69 Yrs.",9064,4610,4454
50,3,27,15,"Nuwakot","70-74 Yrs.",7295,3518,3777
50,3,27,16,"Nuwakot","75-79 Yrs.",4878,2353,2525
50,3,27,17,"Nuwakot","80-84 Yrs.",2455,1174,1281
50,3,27,18,"Nuwakot","85-89 Yrs.",1327,640,687
50,3,27,19,"Nuwakot","90-94 Yrs.",503,227,276
50,3,27,20,"Nuwakot","95+ Yrs.",221,91,130
50,3,28,0,"Kathmandu","All Ages",2041587,1035726,1005861
50,3,28,1,"Kathmandu","00-04 Yrs.",115413,62088,53325
50,3,28,2,"Kathmandu","05-09 Yrs.",138112,75286,62826
50,3,28,3,"Kathmandu","10-14 Yrs.",148419,80326,68093
50,3,28,4,"Kathmandu","15-19 Yrs.",197027,105984,91043
50,3,28,5,"Kathmandu","20-24 Yrs.",226660,114788,111872
50,3,28,6,"Kathmandu","25-29 Yrs.",215120,104411,110709
50,3,28,7,"Kathmandu","30-34 Yrs.",195859,93815,102044
50,3,28,8,"Kathmandu","35-39 Yrs.",177738,86685,91053
50,3,28,9,"Kathmandu","40-44 Yrs.",154111,76587,77524
50,3,28,10,"Kathmandu","45-49 Yrs.",118110,59999,58111
50,3,28,11,"Kathmandu","50-54 Yrs.",107441,55738,51703
50,3,28,12,"Kathmandu","55-59 Yrs.",73520,37953,35567
50,3,28,13,"Kathmandu","60-64 Yrs.",58646,29096,29550
50,3,28,14,"Kathmandu","65-69 Yrs.",42720,20898,21822
50,3,28,15,"Kathmandu","70-74 Yrs.",30674,14202,16472
50,3,28,16,"Kathmandu","75-79 Yrs.",20957,9132,11825
50,3,28,17,"Kathmandu","80-84 Yrs.",11278,4833,6445
50,3,28,18,"Kathmandu","85-89 Yrs.",6342,2583,3759
50,3,28,19,"Kathmandu","90-94 Yrs.",2424,967,1457
50,3,28,20,"Kathmandu","95+ Yrs.",1016,355,661
50,3,29,0,"Bhaktapur","All Ages",432132,218418,213714
50,3,29,1,"Bhaktapur","00-04 Yrs.",28007,15067,12940
50,3,29,2,"Bhaktapur","05-09 Yrs.",30180,16527,13653
50,3,29,3,"Bhaktapur","10-14 Yrs.",31122,16744,14378
50,3,29,4,"Bhaktapur","15-19 Yrs.",37156,19775,17381
50,3,29,5,"Bhaktapur","20-24 Yrs.",43372,22091,21281
50,3,29,6,"Bhaktapur","25-29 Yrs.",44335,21519,22816
50,3,29,7,"Bhaktapur","30-34 Yrs.",41770,20198,21572
50,3,29,8,"Bhaktapur","35-39 Yrs.",38176,18825,19351
50,3,29,9,"Bhaktapur","40-44 Yrs.",33218,16297,16921
50,3,29,10,"Bhaktapur","45-49 Yrs.",26184,13121,13063
50,3,29,11,"Bhaktapur","50-54 Yrs.",23972,12262,11710
50,3,29,12,"Bhaktapur","55-59 Yrs.",16494,8318,8176
50,3,29,13,"Bhaktapur","60-64 Yrs.",12669,6154,6515
50,3,29,14,"Bhaktapur","65-69 Yrs.",9435,4495,4940
50,3,29,15,"Bhaktapur","70-74 Yrs.",6554,2920,3634
50,3,29,16,"Bhaktapur","75-79 Yrs.",4936,2172,2764
50,3,29,17,"Bhaktapur","80-84 Yrs.",2457,1084,1373
50,3,29,18,"Bhaktapur","85-89 Yrs.",1429,596,833
50,3,29,19,"Bhaktapur","90-94 Yrs.",482,188,294
50,3,29,20,"Bhaktapur","95+ Yrs.",184,65,119
50,3,30,0,"Lalitpur","All Ages",551667,277131,274536
50,3,30,1,"Lalitpur","00-04 Yrs.",30402,16265,14137
50,3,30,2,"Lalitpur","05-09 Yrs.",36091,19221,16870
50,3,30,3,"Lalitpur","10-14 Yrs.",39917,21161,18756
50,3,30,4,"Lalitpur","15-19 Yrs.",49017,25718,23299
50,3,30,5,"Lalitpur","20-24 Yrs.",55426,28268,27158
50,3,30,6,"Lalitpur","25-29 Yrs.",52999,25829,27170
50,3,30,7,"Lalitpur","30-34 Yrs.",50048,24305,25743
50,3,30,8,"Lalitpur","35-39 Yrs.",47121,22436,24685
50,3,30,9,"Lalitpur","40-44 Yrs.",43961,21560,22401
50,3,30,10,"Lalitpur","45-49 Yrs.",35106,17605,17501
50,3,30,11,"Lalitpur","50-54 Yrs.",32707,16827,15880
50,3,30,12,"Lalitpur","55-59 Yrs.",22721,11554,11167
50,3,30,13,"Lalitpur","60-64 Yrs.",18521,9092,9429
50,3,30,14,"Lalitpur","65-69 Yrs.",13766,6656,7110
50,3,30,15,"Lalitpur","70-74 Yrs.",9994,4646,5348
50,3,30,16,"Lalitpur","75-79 Yrs.",7007,3072,3935
50,3,30,17,"Lalitpur","80-84 Yrs.",3701,1620,2081
50,3,30,18,"Lalitpur","85-89 Yrs.",2054,859,1195
50,3,30,19,"Lalitpur","90-94 Yrs.",726,299,427
50,3,30,20,"Lalitpur","95+ Yrs.",382,138,244
50,3,31,0,"Kavrepalanchok","All Ages",364039,178909,185130
50,3,31,1,"Kavrepalanchok","00-04 Yrs.",24599,13042,11557
50,3,31,2,"Kavrepalanchok","05-09 Yrs.",27279,14270,13009
50,3,31,3,"Kavrepalanchok","10-14 Yrs.",30070,15251,14819
50,3,31,4,"Kavrepalanchok","15-19 Yrs.",33162,16412,16750
50,3,31,5,"Kavrepalanchok","20-24 Yrs.",31811,15246,16565
50,3,31,6,"Kavrepalanchok","25-29 Yrs.",30844,14881,15963
50,3,31,7,"Kavrepalanchok","30-34 Yrs.",28520,14220,14300
50,3,31,8,"Kavrepalanchok","35-39 Yrs.",27554,13778,13776
50,3,31,9,"Kavrepalanchok","40-44 Yrs.",24329,11597,12732
50,3,31,10,"Kavrepalanchok","45-49 Yrs.",20924,9820,11104
50,3,31,11,"Kavrepalanchok","50-54 Yrs.",21922,10507,11415
50,3,31,12,"Kavrepalanchok","55-59 Yrs.",16860,8173,8687
50,3,31,13,"Kavrepalanchok","60-64 Yrs.",15342,7345,7997
50,3,31,14,"Kavrepalanchok","65-69 Yrs.",11168,5345,5823
50,3,31,15,"Kavrepalanchok","70-74 Yrs.",8556,3966,4590
50,3,31,16,"Kavrepalanchok","75-79 Yrs.",5879,2697,3182
50,3,31,17,"Kavrepalanchok","80-84 Yrs.",2940,1373,1567
50,3,31,18,"Kavrepalanchok","85-89 Yrs.",1522,686,836
50,3,31,19,"Kavrepalanchok","90-94 Yrs.",485,199,286
50,3,31,20,"Kavrepalanchok","95+ Yrs.",273,101,172
50,3,32,0,"Ramechhap","All Ages",170302,80824,89478
50,3,32,1,"Ramechhap","00-04 Yrs.",11028,5670,5358
50,3,32,2,"Ramechhap","05-09 Yrs.",12845,6457,6388
50,3,32,3,"Ramechhap","10-14 Yrs.",16022,7842,8180
50,3,32,4,"Ramechhap","15-19 Yrs.",16704,8084,8620
50,3,32,5,"Ramechhap","20-24 Yrs.",14005,6470,7535
50,3,32,6,"Ramechhap","25-29 Yrs.",11960,5740,6220
50,3,32,7,"Ramechhap","30-34 Yrs.",10448,5024,5424
50,3,32,8,"Ramechhap","35-39 Yrs.",10032,4553,5479
50,3,32,9,"Ramechhap","40-44 Yrs.",9429,4286,5143
50,3,32,10,"Ramechhap","45-49 Yrs.",9157,4088,5069
50,3,32,11,"Ramechhap","50-54 Yrs.",10850,4963,5887
50,3,32,12,"Ramechhap","55-59 Yrs.",9004,4299,4705
50,3,32,13,"Ramechhap","60-64 Yrs.",8743,4245,4498
50,3,32,14,"Ramechhap","65-69 Yrs.",7042,3340,3702
50,3,32,15,"Ramechhap","70-74 Yrs.",5555,2482,3073
50,3,32,16,"Ramechhap","75-79 Yrs.",3829,1739,2090
50,3,32,17,"Ramechhap","80-84 Yrs.",2007,865,1142
50,3,32,18,"Ramechhap","85-89 Yrs.",1111,464,647
50,3,32,19,"Ramechhap","90-94 Yrs.",344,147,197
50,3,32,20,"Ramechhap","95+ Yrs.",187,66,121
50,3,33,0,"Sindhuli","All Ages",300026,147065,152961
50,3,33,1,"Sindhuli","00-04 Yrs.",24127,12453,11674
50,3,33,2,"Sindhuli","05-09 Yrs.",27370,13859,13511
50,3,33,3,"Sindhuli","10-14 Yrs.",31847,16023,15824
50,3,33,4,"Sindhuli","15-19 Yrs.",33738,16618,17120
50,3,33,5,"Sindhuli","20-24 Yrs.",29132,14106,15026
50,3,33,6,"Sindhuli","25-29 Yrs.",23814,11347,12467
50,3,33,7,"Sindhuli","30-34 Yrs.",20157,9647,10510
50,3,33,8,"Sindhuli","35-39 Yrs.",19345,9165,10180
50,3,33,9,"Sindhuli","40-44 Yrs.",16613,7739,8874
50,3,33,10,"Sindhuli","45-49 Yrs.",14778,7185,7593
50,3,33,11,"Sindhuli","50-54 Yrs.",15696,7853,7843
50,3,33,12,"Sindhuli","55-59 Yrs.",11675,5780,5895
50,3,33,13,"Sindhuli","60-64 Yrs.",10146,4996,5150
50,3,33,14,"Sindhuli","65-69 Yrs.",8114,3925,4189
50,3,33,15,"Sindhuli","70-74 Yrs.",6078,2899,3179
50,3,33,16,"Sindhuli","75-79 Yrs.",4072,1946,2126
50,3,33,17,"Sindhuli","80-84 Yrs.",1692,819,873
50,3,33,18,"Sindhuli","85-89 Yrs.",1126,518,608
50,3,33,19,"Sindhuli","90-94 Yrs.",330,130,200
50,3,33,20,"Sindhuli","95+ Yrs.",176,57,119
50,3,34,0,"Makwanpur","All Ages",466073,233816,232257
50,3,34,1,"Makwanpur","00-04 Yrs.",36659,19058,17601
50,3,34,2,"Makwanpur","05-09 Yrs.",40138,20747,19391
50,3,34,3,"Makwanpur","10-14 Yrs.",42925,21756,21169
50,3,34,4,"Makwanpur","15-19 Yrs.",47047,23843,23204
50,3,34,5,"Makwanpur","20-24 Yrs.",46592,23224,23368
50,3,34,6,"Makwanpur","25-29 Yrs.",42602,20981,21621
50,3,34,7,"Makwanpur","30-34 Yrs.",37635,18723,18912
50,3,34,8,"Makwanpur","35-39 Yrs.",33886,17098,16788
50,3,34,9,"Makwanpur","40-44 Yrs.",28771,14265,14506
50,3,34,10,"Makwanpur","45-49 Yrs.",22868,11202,11666
50,3,34,11,"Makwanpur","50-54 Yrs.",23443,11666,11777
50,3,34,12,"Makwanpur","55-59 Yrs.",17372,8743,8629
50,3,34,13,"Makwanpur","60-64 Yrs.",15373,7731,7642
50,3,34,14,"Makwanpur","65-69 Yrs.",11673,5796,5877
50,3,34,15,"Makwanpur","70-74 Yrs.",8236,3887,4349
50,3,34,16,"Makwanpur","75-79 Yrs.",5751,2736,3015
50,3,34,17,"Makwanpur","80-84 Yrs.",2642,1264,1378
50,3,34,18,"Makwanpur","85-89 Yrs.",1606,748,858
50,3,34,19,"Makwanpur","90-94 Yrs.",541,235,306
50,3,34,20,"Makwanpur","95+ Yrs.",313,113,200
50,3,35,0,"Chitawan","All Ages",719859,351789,368070
50,3,35,1,"Chitawan","00-04 Yrs.",50467,27060,23407
50,3,35,2,"Chitawan","05-09 Yrs.",57521,31049,26472
50,3,35,3,"Chitawan","10-14 Yrs.",59748,31578,28170
50,3,35,4,"Chitawan","15-19 Yrs.",69291,35952,33339
50,3,35,5,"Chitawan","20-24 Yrs.",70619,33897,36722
50,3,35,6,"Chitawan","25-29 Yrs.",64683,29092,35591
50,3,35,7,"Chitawan","30-34 Yrs.",57976,25464,32512
50,3,35,8,"Chitawan","35-39 Yrs.",54991,24301,30690
50,3,35,9,"Chitawan","40-44 Yrs.",49485,22913,26572
50,3,35,10,"Chitawan","45-49 Yrs.",39767,19027,20740
50,3,35,11,"Chitawan","50-54 Yrs.",39314,19420,19894
50,3,35,12,"Chitawan","55-59 Yrs.",28684,14483,14201
50,3,35,13,"Chitawan","60-64 Yrs.",24945,12301,12644
50,3,35,14,"Chitawan","65-69 Yrs.",18954,9266,9688
50,3,35,15,"Chitawan","70-74 Yrs.",14197,6755,7442
50,3,35,16,"Chitawan","75-79 Yrs.",9697,4669,5028
50,3,35,17,"Chitawan","80-84 Yrs.",5053,2473,2580
50,3,35,18,"Chitawan","85-89 Yrs.",2728,1333,1395
50,3,35,19,"Chitawan","90-94 Yrs.",1170,531,639
50,3,35,20,"Chitawan","95+ Yrs.",569,225,344
50,4,36,0,"Gorkha","All Ages",251027,118155,132872
50,4,36,1,"Gorkha","00-04 Yrs.",16832,8808,8024
50,4,36,2,"Gorkha","05-09 Yrs.",19596,10077,9519
50,4,36,3,"Gorkha","10-14 Yrs.",22519,11418,11101
50,4,36,4,"Gorkha","15-19 Yrs.",22938,11275,11663
50,4,36,5,"Gorkha","20-24 Yrs.",19666,8827,10839
50,4,36,6,"Gorkha","25-29 Yrs.",18550,8187,10363
50,4,36,7,"Gorkha","30-34 Yrs.",16157,7027,9130
50,4,36,8,"Gorkha","35-39 Yrs.",15557,6790,8767
50,4,36,9,"Gorkha","40-44 Yrs.",14963,6468,8495
50,4,36,10,"Gorkha","45-49 Yrs.",13090,5713,7377
50,4,36,11,"Gorkha","50-54 Yrs.",15279,7008,8271
50,4,36,12,"Gorkha","55-59 Yrs.",12943,6093,6850
50,4,36,13,"Gorkha","60-64 Yrs.",12877,6098,6779
50,4,36,14,"Gorkha","65-69 Yrs.",10582,5127,5455
50,4,36,15,"Gorkha","70-74 Yrs.",8255,3853,4402
50,4,36,16,"Gorkha","75-79 Yrs.",5407,2533,2874
50,4,36,17,"Gorkha","80-84 Yrs.",3132,1580,1552
50,4,36,18,"Gorkha","85-89 Yrs.",1629,806,823
50,4,36,19,"Gorkha","90-94 Yrs.",649,291,358
50,4,36,20,"Gorkha","95+ Yrs.",406,176,230
50,4,37,0,"Manang","All Ages",5658,3192,2466
50,4,37,1,"Manang","00-04 Yrs.",279,137,142
50,4,37,2,"Manang","05-09 Yrs.",292,141,151
50,4,37,3,"Manang","10-14 Yrs.",275,131,144
50,4,37,4,"Manang","15-19 Yrs.",299,163,136
50,4,37,5,"Manang","20-24 Yrs.",522,324,198
50,4,37,6,"Manang","25-29 Yrs.",650,413,237
50,4,37,7,"Manang","30-34 Yrs.",636,413,223
50,4,37,8,"Manang","35-39 Yrs.",545,366,179
50,4,37,9,"Manang","40-44 Yrs.",440,248,192
50,4,37,10,"Manang","45-49 Yrs.",355,189,166
50,4,37,11,"Manang","50-54 Yrs.",327,193,134
50,4,37,12,"Manang","55-59 Yrs.",274,138,136
50,4,37,13,"Manang","60-64 Yrs.",219,103,116
50,4,37,14,"Manang","65-69 Yrs.",218,96,122
50,4,37,15,"Manang","70-74 Yrs.",152,62,90
50,4,37,16,"Manang","75-79 Yrs.",88,38,50
50,4,37,17,"Manang","80-84 Yrs.",55,26,29
50,4,37,18,"Manang","85-89 Yrs.",21,8,13
50,4,37,19,"Manang","90-94 Yrs.",7,1,6
50,4,37,20,"Manang","95+ Yrs.",4,2,2
50,4,38,0,"Mustang","All Ages",14452,7934,6518
50,4,38,1,"Mustang","00-04 Yrs.",763,386,377
50,4,38,2,"Mustang","05-09 Yrs.",1092,560,532
50,4,38,3,"Mustang","10-14 Yrs.",1299,713,586
50,4,38,4,"Mustang","15-19 Yrs.",1222,703,519
50,4,38,5,"Mustang","20-24 Yrs.",1218,708,510
50,4,38,6,"Mustang","25-29 Yrs.",1380,782,598
50,4,38,7,"Mustang","30-34 Yrs.",1302,808,494
50,4,38,8,"Mustang","35-39 Yrs.",1191,720,471
50,4,38,9,"Mustang","40-44 Yrs.",958,519,439
50,4,38,10,"Mustang","45-49 Yrs.",830,402,428
50,4,38,11,"Mustang","50-54 Yrs.",791,430,361
50,4,38,12,"Mustang","55-59 Yrs.",620,329,291
50,4,38,13,"Mustang","60-64 Yrs.",562,277,285
50,4,38,14,"Mustang","65-69 Yrs.",443,232,211
50,4,38,15,"Mustang","70-74 Yrs.",331,160,171
50,4,38,16,"Mustang","75-79 Yrs.",246,119,127
50,4,38,17,"Mustang","80-84 Yrs.",149,64,85
50,4,38,18,"Mustang","85-89 Yrs.",39,14,25
50,4,38,19,"Mustang","90-94 Yrs.",12,7,5
50,4,38,20,"Mustang","95+ Yrs.",4,1,3
50,4,39,0,"Myagdi","All Ages",107033,52153,54880
50,4,39,1,"Myagdi","00-04 Yrs.",8008,4220,3788
50,4,39,2,"Myagdi","05-09 Yrs.",9384,4876,4508
50,4,39,3,"Myagdi","10-14 Yrs.",10191,5142,5049
50,4,39,4,"Myagdi","15-19 Yrs.",9947,5109,4838
50,4,39,5,"Myagdi","20-24 Yrs.",9499,4781,4718
50,4,39,6,"Myagdi","25-29 Yrs.",8400,3983,4417
50,4,39,7,"Myagdi","30-34 Yrs.",7300,3491,3809
50,4,39,8,"Myagdi","35-39 Yrs.",6779,3162,3617
50,4,39,9,"Myagdi","40-44 Yrs.",6084,2767,3317
50,4,39,10,"Myagdi","45-49 Yrs.",5276,2432,2844
50,4,39,11,"Myagdi","50-54 Yrs.",5804,2747,3057
50,4,39,12,"Myagdi","55-59 Yrs.",5087,2409,2678
50,4,39,13,"Myagdi","60-64 Yrs.",4393,2057,2336
50,4,39,14,"Myagdi","65-69 Yrs.",3664,1697,1967
50,4,39,15,"Myagdi","70-74 Yrs.",3088,1375,1713
50,4,39,16,"Myagdi","75-79 Yrs.",2083,971,1112
50,4,39,17,"Myagdi","80-84 Yrs.",1218,573,645
50,4,39,18,"Myagdi","85-89 Yrs.",517,229,288
50,4,39,19,"Myagdi","90-94 Yrs.",223,98,125
50,4,39,20,"Myagdi","95+ Yrs.",88,34,54
50,4,40,0,"Kaski","All Ages",600051,292791,307260
50,4,40,1,"Kaski","00-04 Yrs.",37213,20089,17124
50,4,40,2,"Kaski","05-09 Yrs.",46055,25133,20922
50,4,40,3,"Kaski","10-14 Yrs.",49088,26121,22967
50,4,40,4,"Kaski","15-19 Yrs.",58756,30783,27973
50,4,40,5,"Kaski","20-24 Yrs.",62441,30719,31722
50,4,40,6,"Kaski","25-29 Yrs.",55513,25222,30291
50,4,40,7,"Kaski","30-34 Yrs.",50260,22427,27833
50,4,40,8,"Kaski","35-39 Yrs.",47585,21534,26051
50,4,40,9,"Kaski","40-44 Yrs.",41085,18925,22160
50,4,40,10,"Kaski","45-49 Yrs.",32702,15748,16954
50,4,40,11,"Kaski","50-54 Yrs.",30422,14838,15584
50,4,40,12,"Kaski","55-59 Yrs.",23501,11377,12124
50,4,40,13,"Kaski","60-64 Yrs.",21069,10112,10957
50,4,40,14,"Kaski","65-69 Yrs.",15734,7234,8500
50,4,40,15,"Kaski","70-74 Yrs.",12041,5312,6729
50,4,40,16,"Kaski","75-79 Yrs.",8120,3490,4630
50,4,40,17,"Kaski","80-84 Yrs.",4755,2151,2604
50,4,40,18,"Kaski","85-89 Yrs.",2227,935,1292
50,4,40,19,"Kaski","90-94 Yrs.",986,430,556
50,4,40,20,"Kaski","95+ Yrs.",498,211,287
50,4,41,0,"Lamjung","All Ages",155852,74077,81775
50,4,41,1,"Lamjung","00-04 Yrs.",9306,5004,4302
50,4,41,2,"Lamjung","05-09 Yrs.",11630,6080,5550
50,4,41,3,"Lamjung","10-14 Yrs.",13490,6793,6697
50,4,41,4,"Lamjung","15-19 Yrs.",13704,7033,6671
50,4,41,5,"Lamjung","20-24 Yrs.",12964,6089,6875
50,4,41,6,"Lamjung","25-29 Yrs.",12106,5371,6735
50,4,41,7,"Lamjung","30-34 Yrs.",10688,4675,6013
50,4,41,8,"Lamjung","35-39 Yrs.",10348,4495,5853
50,4,41,9,"Lamjung","40-44 Yrs.",8860,3900,4960
50,4,41,10,"Lamjung","45-49 Yrs.",8306,3687,4619
50,4,41,11,"Lamjung","50-54 Yrs.",9830,4503,5327
50,4,41,12,"Lamjung","55-59 Yrs.",8507,4068,4439
50,4,41,13,"Lamjung","60-64 Yrs.",7983,3769,4214
50,4,41,14,"Lamjung","65-69 Yrs.",6520,3065,3455
50,4,41,15,"Lamjung","70-74 Yrs.",5224,2386,2838
50,4,41,16,"Lamjung","75-79 Yrs.",3094,1553,1541
50,4,41,17,"Lamjung","80-84 Yrs.",1876,929,947
50,4,41,18,"Lamjung","85-89 Yrs.",889,452,437
50,4,41,19,"Lamjung","90-94 Yrs.",313,135,178
50,4,41,20,"Lamjung","95+ Yrs.",214,90,124
50,4,42,0,"Tanahu","All Ages",321153,150094,171059
50,4,42,1,"Tanahu","00-04 Yrs.",21905,11647,10258
50,4,42,2,"Tanahu","05-09 Yrs.",26405,13967,12438
50,4,42,3,"Tanahu","10-14 Yrs.",28872,14816,14056
50,4,42,4,"Tanahu","15-19 Yrs.",31494,15800,15694
50,4,42,5,"Tanahu","20-24 Yrs.",28596,12881,15715
50,4,42,6,"Tanahu","25-29 Yrs.",26564,11044,15520
50,4,42,7,"Tanahu","30-34 Yrs.",23929,10021,13908
50,4,42,8,"Tanahu","35-39 Yrs.",22085,9224,12861
50,4,42,9,"Tanahu","40-44 Yrs.",19372,8323,11049
50,4,42,10,"Tanahu","45-49 Yrs.",17128,7549,9579
50,4,42,11,"Tanahu","50-54 Yrs.",17586,8171,9415
50,4,42,12,"Tanahu","55-59 Yrs.",14515,6853,7662
50,4,42,13,"Tanahu","60-64 Yrs.",13570,6308,7262
50,4,42,14,"Tanahu","65-69 Yrs.",10918,5140,5778
50,4,42,15,"Tanahu","70-74 Yrs.",8312,3811,4501
50,4,42,16,"Tanahu","75-79 Yrs.",5138,2336,2802
50,4,42,17,"Tanahu","80-84 Yrs.",2677,1249,1428
50,4,42,18,"Tanahu","85-89 Yrs.",1322,634,688
50,4,42,19,"Tanahu","90-94 Yrs.",513,226,287
50,4,42,20,"Tanahu","95+ Yrs.",252,94,158
50,4,43,0,"Nawalparasi (Bardaghat Susta East)","All Ages",378079,177887,200192
50,4,43,1,"Nawalparasi (Bardaghat Susta East)","00-04 Yrs.",28493,15256,13237
50,4,43,2,"Nawalparasi (Bardaghat Susta East)","05-09 Yrs.",32825,17520,15305
50,4,43,3,"Nawalparasi (Bardaghat Susta East)","10-14 Yrs.",33984,17706,16278
50,4,43,4,"Nawalparasi (Bardaghat Susta East)","15-19 Yrs.",37117,18673,18444
50,4,43,5,"Nawalparasi (Bardaghat Susta East)","20-24 Yrs.",35305,15676,19629
50,4,43,6,"Nawalparasi (Bardaghat Susta East)","25-29 Yrs.",32781,13162,19619
50,4,43,7,"Nawalparasi (Bardaghat Susta East)","30-34 Yrs.",30337,12383,17954
50,4,43,8,"Nawalparasi (Bardaghat Susta East)","35-39 Yrs.",28103,11847,16256
50,4,43,9,"Nawalparasi (Bardaghat Susta East)","40-44 Yrs.",24654,10814,13840
50,4,43,10,"Nawalparasi (Bardaghat Susta East)","45-49 Yrs.",19557,9112,10445
50,4,43,11,"Nawalparasi (Bardaghat Susta East)","50-54 Yrs.",20049,9479,10570
50,4,43,12,"Nawalparasi (Bardaghat Susta East)","55-59 Yrs.",14809,7099,7710
50,4,43,13,"Nawalparasi (Bardaghat Susta East)","60-64 Yrs.",12820,6032,6788
50,4,43,14,"Nawalparasi (Bardaghat Susta East)","65-69 Yrs.",10273,4908,5365
50,4,43,15,"Nawalparasi (Bardaghat Susta East)","70-74 Yrs.",7642,3699,3943
50,4,43,16,"Nawalparasi (Bardaghat Susta East)","75-79 Yrs.",5012,2393,2619
50,4,43,17,"Nawalparasi (Bardaghat Susta East)","80-84 Yrs.",2472,1257,1215
50,4,43,18,"Nawalparasi (Bardaghat Susta East)","85-89 Yrs.",1106,568,538
50,4,43,19,"Nawalparasi (Bardaghat Susta East)","90-94 Yrs.",448,192,256
50,4,43,20,"Nawalparasi (Bardaghat Susta East)","95+ Yrs.",292,111,181
50,4,44,0,"Syangja","All Ages",253024,116678,136346
50,4,44,1,"Syangja","00-04 Yrs.",16642,8840,7802
50,4,44,2,"Syangja","05-09 Yrs.",19593,10432,9161
50,4,44,3,"Syangja","10-14 Yrs.",20995,10785,10210
50,4,44,4,"Syangja","15-19 Yrs.",23568,11759,11809
50,4,44,5,"Syangja","20-24 Yrs.",21331,9623,11708
50,4,44,6,"Syangja","25-29 Yrs.",19576,8107,11469
50,4,44,7,"Syangja","30-34 Yrs.",17271,7339,9932
50,4,44,8,"Syangja","35-39 Yrs.",15961,6726,9235
50,4,44,9,"Syangja","40-44 Yrs.",14869,6086,8783
50,4,44,10,"Syangja","45-49 Yrs.",13980,5802,8178
50,4,44,11,"Syangja","50-54 Yrs.",14927,6533,8394
50,4,44,12,"Syangja","55-59 Yrs.",12957,5733,7224
50,4,44,13,"Syangja","60-64 Yrs.",12420,5657,6763
50,4,44,14,"Syangja","65-69 Yrs.",10540,4762,5778
50,4,44,15,"Syangja","70-74 Yrs.",8204,3656,4548
50,4,44,16,"Syangja","75-79 Yrs.",5267,2475,2792
50,4,44,17,"Syangja","80-84 Yrs.",2925,1423,1502
50,4,44,18,"Syangja","85-89 Yrs.",1224,610,614
50,4,44,19,"Syangja","90-94 Yrs.",527,232,295
50,4,44,20,"Syangja","95+ Yrs.",247,98,149
50,4,45,0,"Parbat","All Ages",130887,61678,69209
50,4,45,1,"Parbat","00-04 Yrs.",9256,4969,4287
50,4,45,2,"Parbat","05-09 Yrs.",11194,5969,5225
50,4,45,3,"Parbat","10-14 Yrs.",11884,6197,5687
50,4,45,4,"Parbat","15-19 Yrs.",12207,6156,6051
50,4,45,5,"Parbat","20-24 Yrs.",11102,5044,6058
50,4,45,6,"Parbat","25-29 Yrs.",10245,4335,5910
50,4,45,7,"Parbat","30-34 Yrs.",9042,3928,5114
50,4,45,8,"Parbat","35-39 Yrs.",8126,3505,4621
50,4,45,9,"Parbat","40-44 Yrs.",7582,3229,4353
50,4,45,10,"Parbat","45-49 Yrs.",6833,2960,3873
50,4,45,11,"Parbat","50-54 Yrs.",7487,3433,4054
50,4,45,12,"Parbat","55-59 Yrs.",6272,2839,3433
50,4,45,13,"Parbat","60-64 Yrs.",6046,2762,3284
50,4,45,14,"Parbat","65-69 Yrs.",4921,2263,2658
50,4,45,15,"Parbat","70-74 Yrs.",3788,1761,2027
50,4,45,16,"Parbat","75-79 Yrs.",2586,1215,1371
50,4,45,17,"Parbat","80-84 Yrs.",1374,669,705
50,4,45,18,"Parbat","85-89 Yrs.",588,291,297
50,4,45,19,"Parbat","90-94 Yrs.",244,113,131
50,4,45,20,"Parbat","95+ Yrs.",110,40,70
50,4,46,0,"Baglung","All Ages",249211,116194,133017
50,4,46,1,"Baglung","00-04 Yrs.",20233,10753,9480
50,4,46,2,"Baglung","05-09 Yrs.",23957,12570,11387
50,4,46,3,"Baglung","10-14 Yrs.",25218,12952,12266
50,4,46,4,"Baglung","15-19 Yrs.",24993,12173,12820
50,4,46,5,"Baglung","20-24 Yrs.",22226,9766,12460
50,4,46,6,"Baglung","25-29 Yrs.",19244,7964,11280
50,4,46,7,"Baglung","30-34 Yrs.",16700,7247,9453
50,4,46,8,"Baglung","35-39 Yrs.",15055,6355,8700
50,4,46,9,"Baglung","40-44 Yrs.",13566,5609,7957
50,4,46,10,"Baglung","45-49 Yrs.",11936,4974,6962
50,4,46,11,"Baglung","50-54 Yrs.",12563,5629,6934
50,4,46,12,"Baglung","55-59 Yrs.",10495,4788,5707
50,4,46,13,"Baglung","60-64 Yrs.",10231,4692,5539
50,4,46,14,"Baglung","65-69 Yrs.",8227,3794,4433
50,4,46,15,"Baglung","70-74 Yrs.",6588,3022,3566
50,4,46,16,"Baglung","75-79 Yrs.",4352,2093,2259
50,4,46,17,"Baglung","80-84 Yrs.",2154,1123,1031
50,4,46,18,"Baglung","85-89 Yrs.",864,424,440
50,4,46,19,"Baglung","90-94 Yrs.",387,182,205
50,4,46,20,"Baglung","95+ Yrs.",222,84,138
50,5,47,0,"Rukum (East)","All Ages",56786,27516,29270
50,5,47,1,"Rukum (East)","00-04 Yrs.",5616,2932,2684
50,5,47,2,"Rukum (East)","05-09 Yrs.",5868,2933,2935
50,5,47,3,"Rukum (East)","10-14 Yrs.",6196,3078,3118
50,5,47,4,"Rukum (East)","15-19 Yrs.",6392,3170,3222
50,5,47,5,"Rukum (East)","20-24 Yrs.",5708,2610,3098
50,5,47,6,"Rukum (East)","25-29 Yrs.",4403,2075,2328
50,5,47,7,"Rukum (East)","30-34 Yrs.",3633,1750,1883
50,5,47,8,"Rukum (East)","35-39 Yrs.",3242,1540,1702
50,5,47,9,"Rukum (East)","40-44 Yrs.",2713,1223,1490
50,5,47,10,"Rukum (East)","45-49 Yrs.",2535,1170,1365
50,5,47,11,"Rukum (East)","50-54 Yrs.",2615,1255,1360
50,5,47,12,"Rukum (East)","55-59 Yrs.",2152,1063,1089
50,5,47,13,"Rukum (East)","60-64 Yrs.",1948,916,1032
50,5,47,14,"Rukum (East)","65-69 Yrs.",1540,769,771
50,5,47,15,"Rukum (East)","70-74 Yrs.",1272,589,683
50,5,47,16,"Rukum (East)","75-79 Yrs.",593,263,330
50,5,47,17,"Rukum (East)","80-84 Yrs.",234,124,110
50,5,47,18,"Rukum (East)","85-89 Yrs.",78,35,43
50,5,47,19,"Rukum (East)","90-94 Yrs.",28,16,12
50,5,47,20,"Rukum (East)","95+ Yrs.",20,5,15
50,5,48,0,"Rolpa","All Ages",234793,109871,124922
50,5,48,1,"Rolpa","00-04 Yrs.",24079,12418,11661
50,5,48,2,"Rolpa","05-09 Yrs.",24226,12449,11777
50,5,48,3,"Rolpa","10-14 Yrs.",27832,14001,13831
50,5,48,4,"Rolpa","15-19 Yrs.",26459,12553,13906
50,5,48,5,"Rolpa","20-24 Yrs.",23887,10416,13471
50,5,48,6,"Rolpa","25-29 Yrs.",18169,7875,10294
50,5,48,7,"Rolpa","30-34 Yrs.",15741,6822,8919
50,5,48,8,"Rolpa","35-39 Yrs.",12925,5562,7363
50,5,48,9,"Rolpa","40-44 Yrs.",11627,4938,6689
50,5,48,10,"Rolpa","45-49 Yrs.",9956,4409,5547
50,5,48,11,"Rolpa","50-54 Yrs.",10352,4749,5603
50,5,48,12,"Rolpa","55-59 Yrs.",8039,3761,4278
50,5,48,13,"Rolpa","60-64 Yrs.",7173,3348,3825
50,5,48,14,"Rolpa","65-69 Yrs.",5540,2650,2890
50,5,48,15,"Rolpa","70-74 Yrs.",4541,2020,2521
50,5,48,16,"Rolpa","75-79 Yrs.",2643,1201,1442
50,5,48,17,"Rolpa","80-84 Yrs.",1025,438,587
50,5,48,18,"Rolpa","85-89 Yrs.",371,177,194
50,5,48,19,"Rolpa","90-94 Yrs.",139,57,82
50,5,48,20,"Rolpa","95+ Yrs.",69,27,42
50,5,49,0,"Pyuthan","All Ages",232019,104132,127887
50,5,49,1,"Pyuthan","00-04 Yrs.",21525,11251,10274
50,5,49,2,"Pyuthan","05-09 Yrs.",25902,13337,12565
50,5,49,3,"Pyuthan","10-14 Yrs.",28604,14307,14297
50,5,49,4,"Pyuthan","15-19 Yrs.",25578,11577,14001
50,5,49,5,"Pyuthan","20-24 Yrs.",21131,8223,12908
50,5,49,6,"Pyuthan","25-29 Yrs.",17523,6759,10764
50,5,49,7,"Pyuthan","30-34 Yrs.",15019,5870,9149
50,5,49,8,"Pyuthan","35-39 Yrs.",13417,5266,8151
50,5,49,9,"Pyuthan","40-44 Yrs.",11606,4607,6999
50,5,49,10,"Pyuthan","45-49 Yrs.",9813,3996,5817
50,5,49,11,"Pyuthan","50-54 Yrs.",10361,4465,5896
50,5,49,12,"Pyuthan","55-59 Yrs.",8147,3741,4406
50,5,49,13,"Pyuthan","60-64 Yrs.",7844,3601,4243
50,5,49,14,"Pyuthan","65-69 Yrs.",6173,2832,3341
50,5,49,15,"Pyuthan","70-74 Yrs.",4645,2134,2511
50,5,49,16,"Pyuthan","75-79 Yrs.",2795,1255,1540
50,5,49,17,"Pyuthan","80-84 Yrs.",1226,603,623
50,5,49,18,"Pyuthan","85-89 Yrs.",482,229,253
50,5,49,19,"Pyuthan","90-94 Yrs.",155,58,97
50,5,49,20,"Pyuthan","95+ Yrs.",73,21,52
50,5,50,0,"Gulmi","All Ages",246494,112025,134469
50,5,50,1,"Gulmi","00-04 Yrs.",19819,10434,9385
50,5,50,2,"Gulmi","05-09 Yrs.",23305,12305,11000
50,5,50,3,"Gulmi","10-14 Yrs.",24388,12525,11863
50,5,50,4,"Gulmi","15-19 Yrs.",24387,11405,12982
50,5,50,5,"Gulmi","20-24 Yrs.",19596,7772,11824
50,5,50,6,"Gulmi","25-29 Yrs.",18421,7269,11152
50,5,50,7,"Gulmi","30-34 Yrs.",15951,6568,9383
50,5,50,8,"Gulmi","35-39 Yrs.",14263,5575,8688
50,5,50,9,"Gulmi","40-44 Yrs.",12817,5088,7729
50,5,50,10,"Gulmi","45-49 Yrs.",12179,4962,7217
50,5,50,11,"Gulmi","50-54 Yrs.",13596,5821,7775
50,5,50,12,"Gulmi","55-59 Yrs.",11630,5285,6345
50,5,50,13,"Gulmi","60-64 Yrs.",11645,5395,6250
50,5,50,14,"Gulmi","65-69 Yrs.",8866,4139,4727
50,5,50,15,"Gulmi","70-74 Yrs.",7214,3299,3915
50,5,50,16,"Gulmi","75-79 Yrs.",4614,2279,2335
50,5,50,17,"Gulmi","80-84 Yrs.",2266,1170,1096
50,5,50,18,"Gulmi","85-89 Yrs.",977,506,471
50,5,50,19,"Gulmi","90-94 Yrs.",391,172,219
50,5,50,20,"Gulmi","95+ Yrs.",169,56,113
50,5,51,0,"Arghakhanchi","All Ages",177086,80672,96414
50,5,51,1,"Arghakhanchi","00-04 Yrs.",14493,7854,6639
50,5,51,2,"Arghakhanchi","05-09 Yrs.",16962,9035,7927
50,5,51,3,"Arghakhanchi","10-14 Yrs.",18194,9433,8761
50,5,51,4,"Arghakhanchi","15-19 Yrs.",17142,7853,9289
50,5,51,5,"Arghakhanchi","20-24 Yrs.",14106,5474,8632
50,5,51,6,"Arghakhanchi","25-29 Yrs.",13299,5070,8229
50,5,51,7,"Arghakhanchi","30-34 Yrs.",11554,4673,6881
50,5,51,8,"Arghakhanchi","35-39 Yrs.",10578,4188,6390
50,5,51,9,"Arghakhanchi","40-44 Yrs.",9631,3839,5792
50,5,51,10,"Arghakhanchi","45-49 Yrs.",8708,3497,5211
50,5,51,11,"Arghakhanchi","50-54 Yrs.",9712,4144,5568
50,5,51,12,"Arghakhanchi","55-59 Yrs.",8145,3790,4355
50,5,51,13,"Arghakhanchi","60-64 Yrs.",7870,3765,4105
50,5,51,14,"Arghakhanchi","65-69 Yrs.",6073,2854,3219
50,5,51,15,"Arghakhanchi","70-74 Yrs.",4765,2300,2465
50,5,51,16,"Arghakhanchi","75-79 Yrs.",3233,1524,1709
50,5,51,17,"Arghakhanchi","80-84 Yrs.",1587,859,728
50,5,51,18,"Arghakhanchi","85-89 Yrs.",653,357,296
50,5,51,19,"Arghakhanchi","90-94 Yrs.",296,135,161
50,5,51,20,"Arghakhanchi","95+ Yrs.",85,28,57
50,5,52,0,"Palpa","All Ages",245027,112761,132266
50,5,52,1,"Palpa","00-04 Yrs.",17901,9478,8423
50,5,52,2,"Palpa","05-09 Yrs.",20809,10814,9995
50,5,52,3,"Palpa","10-14 Yrs.",22053,11275,10778
50,5,52,4,"Palpa","15-19 Yrs.",24328,11872,12456
50,5,52,5,"Palpa","20-24 Yrs.",21761,9355,12406
50,5,52,6,"Palpa","25-29 Yrs.",20303,8281,12022
50,5,52,7,"Palpa","30-34 Yrs.",18206,7624,10582
50,5,52,8,"Palpa","35-39 Yrs.",16514,6980,9534
50,5,52,9,"Palpa","40-44 Yrs.",14392,6032,8360
50,5,52,10,"Palpa","45-49 Yrs.",13040,5607,7433
50,5,52,11,"Palpa","50-54 Yrs.",13698,6135,7563
50,5,52,12,"Palpa","55-59 Yrs.",10928,5023,5905
50,5,52,13,"Palpa","60-64 Yrs.",10009,4678,5331
50,5,52,14,"Palpa","65-69 Yrs.",8113,3729,4384
50,5,52,15,"Palpa","70-74 Yrs.",5923,2650,3273
50,5,52,16,"Palpa","75-79 Yrs.",3843,1710,2133
50,5,52,17,"Palpa","80-84 Yrs.",1940,931,1009
50,5,52,18,"Palpa","85-89 Yrs.",824,396,428
50,5,52,19,"Palpa","90-94 Yrs.",315,138,177
50,5,52,20,"Palpa","95+ Yrs.",127,53,74
50,5,53,0,"Nawalparasi (Bardaghat Susta West)","All Ages",386868,188182,198686
50,5,53,1,"Nawalparasi (Bardaghat Susta West)","00-04 Yrs.",31133,16306,14827
50,5,53,2,"Nawalparasi (Bardaghat Susta West)","05-09 Yrs.",35081,18442,16639
50,5,53,3,"Nawalparasi (Bardaghat Susta West)","10-14 Yrs.",35451,18261,17190
50,5,53,4,"Nawalparasi (Bardaghat Susta West)","15-19 Yrs.",39105,19816,19289
50,5,53,5,"Nawalparasi (Bardaghat Susta West)","20-24 Yrs.",38435,18088,20347
50,5,53,6,"Nawalparasi (Bardaghat Susta West)","25-29 Yrs.",33849,15014,18835
50,5,53,7,"Nawalparasi (Bardaghat Susta West)","30-34 Yrs.",30210,13391,16819
50,5,53,8,"Nawalparasi (Bardaghat Susta West)","35-39 Yrs.",29437,13293,16144
50,5,53,9,"Nawalparasi (Bardaghat Susta West)","40-44 Yrs.",24428,11491,12937
50,5,53,10,"Nawalparasi (Bardaghat Susta West)","45-49 Yrs.",18446,8922,9524
50,5,53,11,"Nawalparasi (Bardaghat Susta West)","50-54 Yrs.",18503,8852,9651
50,5,53,12,"Nawalparasi (Bardaghat Susta West)","55-59 Yrs.",14096,7147,6949
50,5,53,13,"Nawalparasi (Bardaghat Susta West)","60-64 Yrs.",12153,5788,6365
50,5,53,14,"Nawalparasi (Bardaghat Susta West)","65-69 Yrs.",10829,5413,5416
50,5,53,15,"Nawalparasi (Bardaghat Susta West)","70-74 Yrs.",7974,4019,3955
50,5,53,16,"Nawalparasi (Bardaghat Susta West)","75-79 Yrs.",4314,2216,2098
50,5,53,17,"Nawalparasi (Bardaghat Susta West)","80-84 Yrs.",1910,985,925
50,5,53,18,"Nawalparasi (Bardaghat Susta West)","85-89 Yrs.",810,404,406
50,5,53,19,"Nawalparasi (Bardaghat Susta West)","90-94 Yrs.",359,174,185
50,5,53,20,"Nawalparasi (Bardaghat Susta West)","95+ Yrs.",345,160,185
50,5,54,0,"Rupandehi","All Ages",1121957,550478,571479
50,5,54,1,"Rupandehi","00-04 Yrs.",91687,48500,43187
50,5,54,2,"Rupandehi","05-09 Yrs.",104232,54987,49245
50,5,54,3,"Rupandehi","10-14 Yrs.",108421,56712,51709
50,5,54,4,"Rupandehi","15-19 Yrs.",118480,60597,57883
50,5,54,5,"Rupandehi","20-24 Yrs.",113818,54550,59268
50,5,54,6,"Rupandehi","25-29 Yrs.",99650,44559,55091
50,5,54,7,"Rupandehi","30-34 Yrs.",88863,39458,49405
50,5,54,8,"Rupandehi","35-39 Yrs.",86088,39259,46829
50,5,54,9,"Rupandehi","40-44 Yrs.",70178,33372,36806
50,5,54,10,"Rupandehi","45-49 Yrs.",53252,26046,27206
50,5,54,11,"Rupandehi","50-54 Yrs.",49935,24383,25552
50,5,54,12,"Rupandehi","55-59 Yrs.",37104,18622,18482
50,5,54,13,"Rupandehi","60-64 Yrs.",32756,15964,16792
50,5,54,14,"Rupandehi","65-69 Yrs.",27105,13361,13744
50,5,54,15,"Rupandehi","70-74 Yrs.",20200,9998,10202
50,5,54,16,"Rupandehi","75-79 Yrs.",11025,5613,5412
50,5,54,17,"Rupandehi","80-84 Yrs.",5057,2492,2565
50,5,54,18,"Rupandehi","85-89 Yrs.",2242,1131,1111
50,5,54,19,"Rupandehi","90-94 Yrs.",1060,529,531
50,5,54,20,"Rupandehi","95+ Yrs.",804,345,459
50,5,55,0,"Kapilbastu","All Ages",682961,334687,348274
50,5,55,1,"Kapilbastu","00-04 Yrs.",68627,35060,33567
50,5,55,2,"Kapilbastu","05-09 Yrs.",76056,39026,37030
50,5,55,3,"Kapilbastu","10-14 Yrs.",77895,39807,38088
50,5,55,4,"Kapilbastu","15-19 Yrs.",75880,37510,38370
50,5,55,5,"Kapilbastu","20-24 Yrs.",63995,29817,34178
50,5,55,6,"Kapilbastu","25-29 Yrs.",55703,25343,30360
50,5,55,7,"Kapilbastu","30-34 Yrs.",47136,20951,26185
50,5,55,8,"Kapilbastu","35-39 Yrs.",45035,21057,23978
50,5,55,9,"Kapilbastu","40-44 Yrs.",36453,17484,18969
50,5,55,10,"Kapilbastu","45-49 Yrs.",28138,13966,14172
50,5,55,11,"Kapilbastu","50-54 Yrs.",26551,12943,13608
50,5,55,12,"Kapilbastu","55-59 Yrs.",21037,10947,10090
50,5,55,13,"Kapilbastu","60-64 Yrs.",18109,8875,9234
50,5,55,14,"Kapilbastu","65-69 Yrs.",17135,8727,8408
50,5,55,15,"Kapilbastu","70-74 Yrs.",13772,7039,6733
50,5,55,16,"Kapilbastu","75-79 Yrs.",6712,3644,3068
50,5,55,17,"Kapilbastu","80-84 Yrs.",2689,1444,1245
50,5,55,18,"Kapilbastu","85-89 Yrs.",1066,577,489
50,5,55,19,"Kapilbastu","90-94 Yrs.",487,251,236
50,5,55,20,"Kapilbastu","95+ Yrs.",485,219,266
50,5,56,0,"Dang","All Ages",674993,320573,354420
50,5,56,1,"Dang","00-04 Yrs.",53336,28137,25199
50,5,56,2,"Dang","05-09 Yrs.",62115,32417,29698
50,5,56,3,"Dang","10-14 Yrs.",67451,34666,32785
50,5,56,4,"Dang","15-19 Yrs.",73139,35640,37499
50,5,56,5,"Dang","20-24 Yrs.",67656,29002,38654
50,5,56,6,"Dang","25-29 Yrs.",61815,26338,35477
50,5,56,7,"Dang","30-34 Yrs.",53213,23011,30202
50,5,56,8,"Dang","35-39 Yrs.",48195,21301,26894
50,5,56,9,"Dang","40-44 Yrs.",41641,19243,22398
50,5,56,10,"Dang","45-49 Yrs.",33840,16218,17622
50,5,56,11,"Dang","50-54 Yrs.",31875,15360,16515
50,5,56,12,"Dang","55-59 Yrs.",22282,10965,11317
50,5,56,13,"Dang","60-64 Yrs.",20505,9992,10513
50,5,56,14,"Dang","65-69 Yrs.",15738,7533,8205
50,5,56,15,"Dang","70-74 Yrs.",11805,5708,6097
50,5,56,16,"Dang","75-79 Yrs.",6375,3111,3264
50,5,56,17,"Dang","80-84 Yrs.",2376,1198,1178
50,5,56,18,"Dang","85-89 Yrs.",959,458,501
50,5,56,19,"Dang","90-94 Yrs.",408,176,232
50,5,56,20,"Dang","95+ Yrs.",269,99,170
50,5,57,0,"Banke","All Ages",603194,296745,306449
50,5,57,1,"Banke","00-04 Yrs.",54373,28798,25575
50,5,57,2,"Banke","05-09 Yrs.",63349,33360,29989
50,5,57,3,"Banke","10-14 Yrs.",63298,32805,30493
50,5,57,4,"Banke","15-19 Yrs.",64332,32374,31958
50,5,57,5,"Banke","20-24 Yrs.",61196,28076,33120
50,5,57,6,"Banke","25-29 Yrs.",54122,24246,29876
50,5,57,7,"Banke","30-34 Yrs.",46520,20937,25583
50,5,57,8,"Banke","35-39 Yrs.",43574,20538,23036
50,5,57,9,"Banke","40-44 Yrs.",35601,17573,18028
50,5,57,10,"Banke","45-49 Yrs.",26768,13196,13572
50,5,57,11,"Banke","50-54 Yrs.",24824,12338,12486
50,5,57,12,"Banke","55-59 Yrs.",18269,9304,8965
50,5,57,13,"Banke","60-64 Yrs.",14839,7381,7458
50,5,57,14,"Banke","65-69 Yrs.",12340,6088,6252
50,5,57,15,"Banke","70-74 Yrs.",10801,5266,5535
50,5,57,16,"Banke","75-79 Yrs.",5429,2777,2652
50,5,57,17,"Banke","80-84 Yrs.",1984,978,1006
50,5,57,18,"Banke","85-89 Yrs.",851,433,418
50,5,57,19,"Banke","90-94 Yrs.",380,151,229
50,5,57,20,"Banke","95+ Yrs.",344,126,218
50,5,58,0,"Bardiya","All Ages",459900,216766,243134
50,5,58,1,"Bardiya","00-04 Yrs.",37252,19610,17642
50,5,58,2,"Bardiya","05-09 Yrs.",40033,20745,19288
50,5,58,3,"Bardiya","10-14 Yrs.",43295,22032,21263
50,5,58,4,"Bardiya","15-19 Yrs.",45678,21676,24002
50,5,58,5,"Bardiya","20-24 Yrs.",45357,19142,26215
50,5,58,6,"Bardiya","25-29 Yrs.",43228,18327,24901
50,5,58,7,"Bardiya","30-34 Yrs.",35894,15633,20261
50,5,58,8,"Bardiya","35-39 Yrs.",33825,14881,18944
50,5,58,9,"Bardiya","40-44 Yrs.",27881,12794,15087
50,5,58,10,"Bardiya","45-49 Yrs.",23026,10989,12037
50,5,58,11,"Bardiya","50-54 Yrs.",24345,11314,13031
50,5,58,12,"Bardiya","55-59 Yrs.",17531,8843,8688
50,5,58,13,"Bardiya","60-64 Yrs.",13508,6468,7040
50,5,58,14,"Bardiya","65-69 Yrs.",11468,5489,5979
50,5,58,15,"Bardiya","70-74 Yrs.",9554,4747,4807
50,5,58,16,"Bardiya","75-79 Yrs.",4850,2530,2320
50,5,58,17,"Bardiya","80-84 Yrs.",1863,922,941
50,5,58,18,"Bardiya","85-89 Yrs.",780,408,372
50,5,58,19,"Bardiya","90-94 Yrs.",276,110,166
50,5,58,20,"Bardiya","95+ Yrs.",256,106,150
50,6,59,0,"Dolpa","All Ages",42774,21371,21403
50,6,59,1,"Dolpa","00-04 Yrs.",3638,1819,1819
50,6,59,2,"Dolpa","05-09 Yrs.",4785,2427,2358
50,6,59,3,"Dolpa","10-14 Yrs.",5130,2515,2615
50,6,59,4,"Dolpa","15-19 Yrs.",4792,2332,2460
50,6,59,5,"Dolpa","20-24 Yrs.",4337,2127,2210
50,6,59,6,"Dolpa","25-29 Yrs.",3981,2011,1970
50,6,59,7,"Dolpa","30-34 Yrs.",3241,1684,1557
50,6,59,8,"Dolpa","35-39 Yrs.",2918,1527,1391
50,6,59,9,"Dolpa","40-44 Yrs.",2297,1130,1167
50,6,59,10,"Dolpa","45-49 Yrs.",1991,1009,982
50,6,59,11,"Dolpa","50-54 Yrs.",1611,854,757
50,6,59,12,"Dolpa","55-59 Yrs.",1403,688,715
50,6,59,13,"Dolpa","60-64 Yrs.",1136,527,609
50,6,59,14,"Dolpa","65-69 Yrs.",720,362,358
50,6,59,15,"Dolpa","70-74 Yrs.",495,227,268
50,6,59,16,"Dolpa","75-79 Yrs.",212,87,125
50,6,59,17,"Dolpa","80-84 Yrs.",48,28,20
50,6,59,18,"Dolpa","85-89 Yrs.",24,11,13
50,6,59,19,"Dolpa","90-94 Yrs.",10,4,6
50,6,59,20,"Dolpa","95+ Yrs.",5,2,3
50,6,60,0,"Mugu","All Ages",64549,32381,32168
50,6,60,1,"Mugu","00-04 Yrs.",6940,3529,3411
50,6,60,2,"Mugu","05-09 Yrs.",8270,4274,3996
50,6,60,3,"Mugu","10-14 Yrs.",8680,4452,4228
50,6,60,4,"Mugu","15-19 Yrs.",6785,3238,3547
50,6,60,5,"Mugu","20-24 Yrs.",6310,3016,3294
50,6,60,6,"Mugu","25-29 Yrs.",4926,2474,2452
50,6,60,7,"Mugu","30-34 Yrs.",4171,2065,2106
50,6,60,8,"Mugu","35-39 Yrs.",3618,1807,1811
50,6,60,9,"Mugu","40-44 Yrs.",2985,1475,1510
50,6,60,10,"Mugu","45-49 Yrs.",2666,1354,1312
50,6,60,11,"Mugu","50-54 Yrs.",2291,1189,1102
50,6,60,12,"Mugu","55-59 Yrs.",2077,1164,913
50,6,60,13,"Mugu","60-64 Yrs.",1778,860,918
50,6,60,14,"Mugu","65-69 Yrs.",1093,569,524
50,6,60,15,"Mugu","70-74 Yrs.",1198,541,657
50,6,60,16,"Mugu","75-79 Yrs.",499,250,249
50,6,60,17,"Mugu","80-84 Yrs.",162,77,85
50,6,60,18,"Mugu","85-89 Yrs.",60,33,27
50,6,60,19,"Mugu","90-94 Yrs.",28,10,18
50,6,60,20,"Mugu","95+ Yrs.",12,4,8
50,6,61,0,"Humla","All Ages",55394,27886,27508
50,6,61,1,"Humla","00-04 Yrs.",6069,3123,2946
50,6,61,2,"Humla","05-09 Yrs.",6759,3414,3345
50,6,61,3,"Humla","10-14 Yrs.",7172,3624,3548
50,6,61,4,"Humla","15-19 Yrs.",5281,2510,2771
50,6,61,5,"Humla","20-24 Yrs.",4386,2129,2257
50,6,61,6,"Humla","25-29 Yrs.",4046,2073,1973
50,6,61,7,"Humla","30-34 Yrs.",3863,1938,1925
50,6,61,8,"Humla","35-39 Yrs.",3623,1874,1749
50,6,61,9,"Humla","40-44 Yrs.",2832,1372,1460
50,6,61,10,"Humla","45-49 Yrs.",2463,1297,1166
50,6,61,11,"Humla","50-54 Yrs.",2261,1185,1076
50,6,61,12,"Humla","55-59 Yrs.",1909,1033,876
50,6,61,13,"Humla","60-64 Yrs.",1754,881,873
50,6,61,14,"Humla","65-69 Yrs.",1099,572,527
50,6,61,15,"Humla","70-74 Yrs.",1008,465,543
50,6,61,16,"Humla","75-79 Yrs.",522,230,292
50,6,61,17,"Humla","80-84 Yrs.",200,99,101
50,6,61,18,"Humla","85-89 Yrs.",86,43,43
50,6,61,19,"Humla","90-94 Yrs.",34,16,18
50,6,61,20,"Humla","95+ Yrs.",27,8,19
50,6,62,0,"Jumla","All Ages",118349,59228,59121
50,6,62,1,"Jumla","00-04 Yrs.",10702,5705,4997
50,6,62,2,"Jumla","05-09 Yrs.",12579,6491,6088
50,6,62,3,"Jumla","10-14 Yrs.",14638,7309,7329
50,6,62,4,"Jumla","15-19 Yrs.",14003,6814,7189
50,6,62,5,"Jumla","20-24 Yrs.",12751,6012,6739
50,6,62,6,"Jumla","25-29 Yrs.",9927,4967,4960
50,6,62,7,"Jumla","30-34 Yrs.",8229,4077,4152
50,6,62,8,"Jumla","35-39 Yrs.",7236,3698,3538
50,6,62,9,"Jumla","40-44 Yrs.",6152,2870,3282
50,6,62,10,"Jumla","45-49 Yrs.",5473,2872,2601
50,6,62,11,"Jumla","50-54 Yrs.",4674,2342,2332
50,6,62,12,"Jumla","55-59 Yrs.",3874,2019,1855
50,6,62,13,"Jumla","60-64 Yrs.",3261,1637,1624
50,6,62,14,"Jumla","65-69 Yrs.",1959,983,976
50,6,62,15,"Jumla","70-74 Yrs.",1891,924,967
50,6,62,16,"Jumla","75-79 Yrs.",635,323,312
50,6,62,17,"Jumla","80-84 Yrs.",238,131,107
50,6,62,18,"Jumla","85-89 Yrs.",64,31,33
50,6,62,19,"Jumla","90-94 Yrs.",24,6,18
50,6,62,20,"Jumla","95+ Yrs.",39,17,22
50,6,63,0,"Kalikot","All Ages",145292,72245,73047
50,6,63,1,"Kalikot","00-04 Yrs.",16614,8717,7897
50,6,63,2,"Kalikot","05-09 Yrs.",16998,8683,8315
50,6,63,3,"Kalikot","10-14 Yrs.",20323,10366,9957
50,6,63,4,"Kalikot","15-19 Yrs.",17739,8513,9226
50,6,63,5,"Kalikot","20-24 Yrs.",14786,6921,7865
50,6,63,6,"Kalikot","25-29 Yrs.",10366,5262,5104
50,6,63,7,"Kalikot","30-34 Yrs.",8113,3963,4150
50,6,63,8,"Kalikot","35-39 Yrs.",7332,3598,3734
50,6,63,9,"Kalikot","40-44 Yrs.",6112,2823,3289
50,6,63,10,"Kalikot","45-49 Yrs.",5688,2785,2903
50,6,63,11,"Kalikot","50-54 Yrs.",5310,2667,2643
50,6,63,12,"Kalikot","55-59 Yrs.",4631,2441,2190
50,6,63,13,"Kalikot","60-64 Yrs.",4414,2134,2280
50,6,63,14,"Kalikot","65-69 Yrs.",2762,1403,1359
50,6,63,15,"Kalikot","70-74 Yrs.",2405,1149,1256
50,6,63,16,"Kalikot","75-79 Yrs.",1073,508,565
50,6,63,17,"Kalikot","80-84 Yrs.",392,202,190
50,6,63,18,"Kalikot","85-89 Yrs.",139,69,70
50,6,63,19,"Kalikot","90-94 Yrs.",57,26,31
50,6,63,20,"Kalikot","95+ Yrs.",38,15,23
50,6,64,0,"Dailekh","All Ages",252313,120774,131539
50,6,64,1,"Dailekh","00-04 Yrs.",26805,13939,12866
50,6,64,2,"Dailekh","05-09 Yrs.",27752,14059,13693
50,6,64,3,"Dailekh","10-14 Yrs.",32084,16082,16002
50,6,64,4,"Dailekh","15-19 Yrs.",29519,14101,15418
50,6,64,5,"Dailekh","20-24 Yrs.",24907,11098,13809
50,6,64,6,"Dailekh","25-29 Yrs.",18797,8686,10111
50,6,64,7,"Dailekh","30-34 Yrs.",14501,6731,7770
50,6,64,8,"Dailekh","35-39 Yrs.",13443,5723,7720
50,6,64,9,"Dailekh","40-44 Yrs.",12103,5393,6710
50,6,64,10,"Dailekh","45-49 Yrs.",10610,4711,5899
50,6,64,11,"Dailekh","50-54 Yrs.",11135,5274,5861
50,6,64,12,"Dailekh","55-59 Yrs.",8283,4156,4127
50,6,64,13,"Dailekh","60-64 Yrs.",7601,3776,3825
50,6,64,14,"Dailekh","65-69 Yrs.",5713,2864,2849
50,6,64,15,"Dailekh","70-74 Yrs.",4942,2192,2750
50,6,64,16,"Dailekh","75-79 Yrs.",2652,1255,1397
50,6,64,17,"Dailekh","80-84 Yrs.",939,496,443
50,6,64,18,"Dailekh","85-89 Yrs.",337,166,171
50,6,64,19,"Dailekh","90-94 Yrs.",121,50,71
50,6,64,20,"Dailekh","95+ Yrs.",69,22,47
50,6,65,0,"Jajarkot","All Ages",189360,94063,95297
50,6,65,1,"Jajarkot","00-04 Yrs.",21610,11058,10552
50,6,65,2,"Jajarkot","05-09 Yrs.",22716,11492,11224
50,6,65,3,"Jajarkot","10-14 Yrs.",26051,13008,13043
50,6,65,4,"Jajarkot","15-19 Yrs.",23161,11321,11840
50,6,65,5,"Jajarkot","20-24 Yrs.",18766,9040,9726
50,6,65,6,"Jajarkot","25-29 Yrs.",13651,6824,6827
50,6,65,7,"Jajarkot","30-34 Yrs.",10894,5366,5528
50,6,65,8,"Jajarkot","35-39 Yrs.",10281,4903,5378
50,6,65,9,"Jajarkot","40-44 Yrs.",8896,4237,4659
50,6,65,10,"Jajarkot","45-49 Yrs.",7652,3816,3836
50,6,65,11,"Jajarkot","50-54 Yrs.",7212,3693,3519
50,6,65,12,"Jajarkot","55-59 Yrs.",5316,2791,2525
50,6,65,13,"Jajarkot","60-64 Yrs.",4863,2482,2381
50,6,65,14,"Jajarkot","65-69 Yrs.",3406,1818,1588
50,6,65,15,"Jajarkot","70-74 Yrs.",2772,1273,1499
50,6,65,16,"Jajarkot","75-79 Yrs.",1432,623,809
50,6,65,17,"Jajarkot","80-84 Yrs.",421,201,220
50,6,65,18,"Jajarkot","85-89 Yrs.",165,81,84
50,6,65,19,"Jajarkot","90-94 Yrs.",70,23,47
50,6,65,20,"Jajarkot","95+ Yrs.",25,13,12
50,6,66,0,"Rukum (West)","All Ages",166740,81091,85649
50,6,66,1,"Rukum (West)","00-04 Yrs.",16539,8835,7704
50,6,66,2,"Rukum (West)","05-09 Yrs.",17422,8980,8442
50,6,66,3,"Rukum (West)","10-14 Yrs.",20208,10216,9992
50,6,66,4,"Rukum (West)","15-19 Yrs.",19863,9551,10312
50,6,66,5,"Rukum (West)","20-24 Yrs.",17685,8091,9594
50,6,66,6,"Rukum (West)","25-29 Yrs.",13247,6211,7036
50,6,66,7,"Rukum (West)","30-34 Yrs.",11274,5316,5958
50,6,66,8,"Rukum (West)","35-39 Yrs.",9586,4469,5117
50,6,66,9,"Rukum (West)","40-44 Yrs.",8503,3848,4655
50,6,66,10,"Rukum (West)","45-49 Yrs.",7068,3327,3741
50,6,66,11,"Rukum (West)","50-54 Yrs.",6731,3226,3505
50,6,66,12,"Rukum (West)","55-59 Yrs.",5300,2608,2692
50,6,66,13,"Rukum (West)","60-64 Yrs.",4715,2254,2461
50,6,66,14,"Rukum (West)","65-69 Yrs.",3517,1741,1776
50,6,66,15,"Rukum (West)","70-74 Yrs.",2913,1378,1535
50,6,66,16,"Rukum (West)","75-79 Yrs.",1369,666,703
50,6,66,17,"Rukum (West)","80-84 Yrs.",510,240,270
50,6,66,18,"Rukum (West)","85-89 Yrs.",174,86,88
50,6,66,19,"Rukum (West)","90-94 Yrs.",69,29,40
50,6,66,20,"Rukum (West)","95+ Yrs.",47,19,28
50,6,67,0,"Salyan","All Ages",238515,114982,123533
50,6,67,1,"Salyan","00-04 Yrs.",23098,12150,10948
50,6,67,2,"Salyan","05-09 Yrs.",23373,11951,11422
50,6,67,3,"Salyan","10-14 Yrs.",26759,13615,13144
50,6,67,4,"Salyan","15-19 Yrs.",28209,13788,14421
50,6,67,5,"Salyan","20-24 Yrs.",25164,11519,13645
50,6,67,6,"Salyan","25-29 Yrs.",19257,8871,10386
50,6,67,7,"Salyan","30-34 Yrs.",15514,7082,8432
50,6,67,8,"Salyan","35-39 Yrs.",14054,6246,7808
50,6,67,9,"Salyan","40-44 Yrs.",12814,5747,7067
50,6,67,10,"Salyan","45-49 Yrs.",10969,5049,5920
50,6,67,11,"Salyan","50-54 Yrs.",10658,5146,5512
50,6,67,12,"Salyan","55-59 Yrs.",8033,3937,4096
50,6,67,13,"Salyan","60-64 Yrs.",7235,3485,3750
50,6,67,14,"Salyan","65-69 Yrs.",5874,2843,3031
50,6,67,15,"Salyan","70-74 Yrs.",4213,1967,2246
50,6,67,16,"Salyan","75-79 Yrs.",2190,1070,1120
50,6,67,17,"Salyan","80-84 Yrs.",675,317,358
50,6,67,18,"Salyan","85-89 Yrs.",249,130,119
50,6,67,19,"Salyan","90-94 Yrs.",100,40,60
50,6,67,20,"Salyan","95+ Yrs.",77,29,48
50,6,68,0,"Surkhet","All Ages",415126,199740,215386
50,6,68,1,"Surkhet","00-04 Yrs.",36786,19683,17103
50,6,68,2,"Surkhet","05-09 Yrs.",41064,21574,19490
50,6,68,3,"Surkhet","10-14 Yrs.",47327,24484,22843
50,6,68,4,"Surkhet","15-19 Yrs.",47392,23384,24008
50,6,68,5,"Surkhet","20-24 Yrs.",42169,18841,23328
50,6,68,6,"Surkhet","25-29 Yrs.",35134,15468,19666
50,6,68,7,"Surkhet","30-34 Yrs.",30829,13538,17291
50,6,68,8,"Surkhet","35-39 Yrs.",28399,12757,15642
50,6,68,9,"Surkhet","40-44 Yrs.",23445,10796,12649
50,6,68,10,"Surkhet","45-49 Yrs.",18475,8710,9765
50,6,68,11,"Surkhet","50-54 Yrs.",17823,8518,9305
50,6,68,12,"Surkhet","55-59 Yrs.",12857,6257,6600
50,6,68,13,"Surkhet","60-64 Yrs.",11230,5394,5836
50,6,68,14,"Surkhet","65-69 Yrs.",8637,4041,4596
50,6,68,15,"Surkhet","70-74 Yrs.",6933,3236,3697
50,6,68,16,"Surkhet","75-79 Yrs.",3869,1778,2091
50,6,68,17,"Surkhet","80-84 Yrs.",1665,814,851
50,6,68,18,"Surkhet","85-89 Yrs.",668,323,345
50,6,68,19,"Surkhet","90-94 Yrs.",229,79,150
50,6,68,20,"Surkhet","95+ Yrs.",195,65,130
50,7,69,0,"Bajura","All Ages",138523,67070,71453
50,7,69,1,"Bajura","00-04 Yrs.",14623,7606,7017
50,7,69,2,"Bajura","05-09 Yrs.",16227,8158,8069
50,7,69,3,"Bajura","10-14 Yrs.",19080,9643,9437
50,7,69,4,"Bajura","15-19 Yrs.",15659,7325,8334
50,7,69,5,"Bajura","20-24 Yrs.",12817,5709,7108
50,7,69,6,"Bajura","25-29 Yrs.",9068,4484,4584
50,7,69,7,"Bajura","30-34 Yrs.",7638,3562,4076
50,7,69,8,"Bajura","35-39 Yrs.",7949,3718,4231
50,7,69,9,"Bajura","40-44 Yrs.",6754,3135,3619
50,7,69,10,"Bajura","45-49 Yrs.",6042,2814,3228
50,7,69,11,"Bajura","50-54 Yrs.",5766,2821,2945
50,7,69,12,"Bajura","55-59 Yrs.",4378,2231,2147
50,7,69,13,"Bajura","60-64 Yrs.",3855,1859,1996
50,7,69,14,"Bajura","65-69 Yrs.",3141,1526,1615
50,7,69,15,"Bajura","70-74 Yrs.",2942,1355,1587
50,7,69,16,"Bajura","75-79 Yrs.",1623,707,916
50,7,69,17,"Bajura","80-84 Yrs.",566,270,296
50,7,69,18,"Bajura","85-89 Yrs.",210,83,127
50,7,69,19,"Bajura","90-94 Yrs.",114,38,76
50,7,69,20,"Bajura","95+ Yrs.",71,26,45
50,7,70,0,"Bajhang","All Ages",189085,88470,100615
50,7,70,1,"Bajhang","00-04 Yrs.",18672,9757,8915
50,7,70,2,"Bajhang","05-09 Yrs.",22563,11434,11129
50,7,70,3,"Bajhang","10-14 Yrs.",27131,13643,13488
50,7,70,4,"Bajhang","15-19 Yrs.",22266,10180,12086
50,7,70,5,"Bajhang","20-24 Yrs.",16840,7288,9552
50,7,70,6,"Bajhang","25-29 Yrs.",11942,5488,6454
50,7,70,7,"Bajhang","30-34 Yrs.",10429,4665,5764
50,7,70,8,"Bajhang","35-39 Yrs.",10249,4476,5773
50,7,70,9,"Bajhang","40-44 Yrs.",9413,4042,5371
50,7,70,10,"Bajhang","45-49 Yrs.",7716,3374,4342
50,7,70,11,"Bajhang","50-54 Yrs.",7877,3717,4160
50,7,70,12,"Bajhang","55-59 Yrs.",5795,2800,2995
50,7,70,13,"Bajhang","60-64 Yrs.",5318,2449,2869
50,7,70,14,"Bajhang","65-69 Yrs.",4372,1975,2397
50,7,70,15,"Bajhang","70-74 Yrs.",4371,1674,2697
50,7,70,16,"Bajhang","75-79 Yrs.",2487,980,1507
50,7,70,17,"Bajhang","80-84 Yrs.",1005,344,661
50,7,70,18,"Bajhang","85-89 Yrs.",351,117,234
50,7,70,19,"Bajhang","90-94 Yrs.",195,47,148
50,7,70,20,"Bajhang","95+ Yrs.",93,20,73
50,7,71,0,"Darchula","All Ages",133310,64424,68886
50,7,71,1,"Darchula","00-04 Yrs.",10970,5824,5146
50,7,71,2,"Darchula","05-09 Yrs.",13088,6620,6468
50,7,71,3,"Darchula","10-14 Yrs.",16219,8156,8063
50,7,71,4,"Darchula","15-19 Yrs.",14625,7105,7520
50,7,71,5,"Darchula","20-24 Yrs.",12176,5386,6790
50,7,71,6,"Darchula","25-29 Yrs.",9806,4567,5239
50,7,71,7,"Darchula","30-34 Yrs.",8699,3971,4728
50,7,71,8,"Darchula","35-39 Yrs.",8337,3853,4484
50,7,71,9,"Darchula","40-44 Yrs.",7399,3507,3892
50,7,71,10,"Darchula","45-49 Yrs.",6494,3091,3403
50,7,71,11,"Darchula","50-54 Yrs.",6322,3016,3306
50,7,71,12,"Darchula","55-59 Yrs.",4896,2480,2416
50,7,71,13,"Darchula","60-64 Yrs.",4237,2104,2133
50,7,71,14,"Darchula","65-69 Yrs.",3797,1884,1913
50,7,71,15,"Darchula","70-74 Yrs.",2992,1338,1654
50,7,71,16,"Darchula","75-79 Yrs.",1845,852,993
50,7,71,17,"Darchula","80-84 Yrs.",850,415,435
50,7,71,18,"Darchula","85-89 Yrs.",327,159,168
50,7,71,19,"Darchula","90-94 Yrs.",128,55,73
50,7,71,20,"Darchula","95+ Yrs.",103,41,62
50,7,72,0,"Baitadi","All Ages",242157,113864,128293
50,7,72,1,"Baitadi","00-04 Yrs.",23151,12376,10775
50,7,72,2,"Baitadi","05-09 Yrs.",24706,12638,12068
50,7,72,3,"Baitadi","10-14 Yrs.",30991,15639,15352
50,7,72,4,"Baitadi","15-19 Yrs.",27277,13019,14258
50,7,72,5,"Baitadi","20-24 Yrs.",22481,9216,13265
50,7,72,6,"Baitadi","25-29 Yrs.",16839,7428,9411
50,7,72,7,"Baitadi","30-34 Yrs.",14708,6575,8133
50,7,72,8,"Baitadi","35-39 Yrs.",13572,5900,7672
50,7,72,9,"Baitadi","40-44 Yrs.",12577,5621,6956
50,7,72,10,"Baitadi","45-49 Yrs.",10979,4861,6118
50,7,72,11,"Baitadi","50-54 Yrs.",11093,5134,5959
50,7,72,12,"Baitadi","55-59 Yrs.",8723,4334,4389
50,7,72,13,"Baitadi","60-64 Yrs.",7550,3564,3986
50,7,72,14,"Baitadi","65-69 Yrs.",6141,2931,3210
50,7,72,15,"Baitadi","70-74 Yrs.",5369,2282,3087
50,7,72,16,"Baitadi","75-79 Yrs.",3437,1306,2131
50,7,72,17,"Baitadi","80-84 Yrs.",1575,663,912
50,7,72,18,"Baitadi","85-89 Yrs.",560,252,308
50,7,72,19,"Baitadi","90-94 Yrs.",288,83,205
50,7,72,20,"Baitadi","95+ Yrs.",140,42,98
50,7,73,0,"Dadeldhura","All Ages",139602,65893,73709
50,7,73,1,"Dadeldhura","00-04 Yrs.",12910,6951,5959
50,7,73,2,"Dadeldhura","05-09 Yrs.",14132,7433,6699
50,7,73,3,"Dadeldhura","10-14 Yrs.",16638,8479,8159
50,7,73,4,"Dadeldhura","15-19 Yrs.",15439,7267,8172
50,7,73,5,"Dadeldhura","20-24 Yrs.",13407,5520,7887
50,7,73,6,"Dadeldhura","25-29 Yrs.",10533,4598,5935
50,7,73,7,"Dadeldhura","30-34 Yrs.",9001,4133,4868
50,7,73,8,"Dadeldhura","35-39 Yrs.",8505,3812,4693
50,7,73,9,"Dadeldhura","40-44 Yrs.",7208,3308,3900
50,7,73,10,"Dadeldhura","45-49 Yrs.",6529,2971,3558
50,7,73,11,"Dadeldhura","50-54 Yrs.",6552,3004,3548
50,7,73,12,"Dadeldhura","55-59 Yrs.",4757,2341,2416
50,7,73,13,"Dadeldhura","60-64 Yrs.",4368,2042,2326
50,7,73,14,"Dadeldhura","65-69 Yrs.",3341,1566,1775
50,7,73,15,"Dadeldhura","70-74 Yrs.",3119,1218,1901
50,7,73,16,"Dadeldhura","75-79 Yrs.",1820,784,1036
50,7,73,17,"Dadeldhura","80-84 Yrs.",778,287,491
50,7,73,18,"Dadeldhura","85-89 Yrs.",340,128,212
50,7,73,19,"Dadeldhura","90-94 Yrs.",140,29,111
50,7,73,20,"Dadeldhura","95+ Yrs.",85,22,63
50,7,74,0,"Doti","All Ages",204831,93604,111227
50,7,74,1,"Doti","00-04 Yrs.",22109,11756,10353
50,7,74,2,"Doti","05-09 Yrs.",24729,12726,12003
50,7,74,3,"Doti","10-14 Yrs.",28185,14374,13811
50,7,74,4,"Doti","15-19 Yrs.",22855,10552,12303
50,7,74,5,"Doti","20-24 Yrs.",18462,7567,10895
50,7,74,6,"Doti","25-29 Yrs.",13990,5721,8269
50,7,74,7,"Doti","30-34 Yrs.",12083,4980,7103
50,7,74,8,"Doti","35-39 Yrs.",10924,4515,6409
50,7,74,9,"Doti","40-44 Yrs.",9893,3918,5975
50,7,74,10,"Doti","45-49 Yrs.",8196,3451,4745
50,7,74,11,"Doti","50-54 Yrs.",8232,3450,4782
50,7,74,12,"Doti","55-59 Yrs.",6269,2798,3471
50,7,74,13,"Doti","60-64 Yrs.",6243,2632,3611
50,7,74,14,"Doti","65-69 Yrs.",4631,2012,2619
50,7,74,15,"Doti","70-74 Yrs.",4299,1698,2601
50,7,74,16,"Doti","75-79 Yrs.",2165,896,1269
50,7,74,17,"Doti","80-84 Yrs.",990,362,628
50,7,74,18,"Doti","85-89 Yrs.",323,138,185
50,7,74,19,"Doti","90-94 Yrs.",140,42,98
50,7,74,20,"Doti","95+ Yrs.",113,16,97
50,7,75,0,"Achham","All Ages",228852,105319,123533
50,7,75,1,"Achham","00-04 Yrs.",25081,12955,12126
50,7,75,2,"Achham","05-09 Yrs.",28349,14354,13995
50,7,75,3,"Achham","10-14 Yrs.",33180,16402,16778
50,7,75,4,"Achham","15-19 Yrs.",26258,11817,14441
50,7,75,5,"Achham","20-24 Yrs.",19723,8269,11454
50,7,75,6,"Achham","25-29 Yrs.",14458,6435,8023
50,7,75,7,"Achham","30-34 Yrs.",12352,5301,7051
50,7,75,8,"Achham","35-39 Yrs.",11867,5118,6749
50,7,75,9,"Achham","40-44 Yrs.",10289,4220,6069
50,7,75,10,"Achham","45-49 Yrs.",8763,3750,5013
50,7,75,11,"Achham","50-54 Yrs.",9154,3926,5228
50,7,75,12,"Achham","55-59 Yrs.",6951,3258,3693
50,7,75,13,"Achham","60-64 Yrs.",6351,2901,3450
50,7,75,14,"Achham","65-69 Yrs.",4998,2307,2691
50,7,75,15,"Achham","70-74 Yrs.",5535,2153,3382
50,7,75,16,"Achham","75-79 Yrs.",3394,1344,2050
50,7,75,17,"Achham","80-84 Yrs.",1299,518,781
50,7,75,18,"Achham","85-89 Yrs.",465,189,276
50,7,75,19,"Achham","90-94 Yrs.",277,77,200
50,7,75,20,"Achham","95+ Yrs.",108,25,83
50,7,76,0,"Kailali","All Ages",904666,433456,471210
50,7,76,1,"Kailali","00-04 Yrs.",70259,37954,32305
50,7,76,2,"Kailali","05-09 Yrs.",82250,43574,38676
50,7,76,3,"Kailali","10-14 Yrs.",97139,49961,47178
50,7,76,4,"Kailali","15-19 Yrs.",97479,47131,50348
50,7,76,5,"Kailali","20-24 Yrs.",93118,40932,52186
50,7,76,6,"Kailali","25-29 Yrs.",82086,36461,45625
50,7,76,7,"Kailali","30-34 Yrs.",71168,31921,39247
50,7,76,8,"Kailali","35-39 Yrs.",65324,30082,35242
50,7,76,9,"Kailali","40-44 Yrs.",53137,25114,28023
50,7,76,10,"Kailali","45-49 Yrs.",41462,19418,22044
50,7,76,11,"Kailali","50-54 Yrs.",41316,19479,21837
50,7,76,12,"Kailali","55-59 Yrs.",29288,14208,15080
50,7,76,13,"Kailali","60-64 Yrs.",24395,11415,12980
50,7,76,14,"Kailali","65-69 Yrs.",20867,9813,11054
50,7,76,15,"Kailali","70-74 Yrs.",18642,8354,10288
50,7,76,16,"Kailali","75-79 Yrs.",9899,4672,5227
50,7,76,17,"Kailali","80-84 Yrs.",3893,1726,2167
50,7,76,18,"Kailali","85-89 Yrs.",1610,751,859
50,7,76,19,"Kailali","90-94 Yrs.",800,307,493
50,7,76,20,"Kailali","95+ Yrs.",534,183,351
50,7,77,0,"Kanchanpur","All Ages",513757,240686,273071
50,7,77,1,"Kanchanpur","00-04 Yrs.",41364,22589,18775
50,7,77,2,"Kanchanpur","05-09 Yrs.",46196,24828,21368
50,7,77,3,"Kanchanpur","10-14 Yrs.",55785,28920,26865
50,7,77,4,"Kanchanpur","15-19 Yrs.",56091,27035,29056
50,7,77,5,"Kanchanpur","20-24 Yrs.",51679,21238,30441
50,7,77,6,"Kanchanpur","25-29 Yrs.",44380,18039,26341
50,7,77,7,"Kanchanpur","30-34 Yrs.",38024,15897,22127
50,7,77,8,"Kanchanpur","35-39 Yrs.",35183,15133,20050
50,7,77,9,"Kanchanpur","40-44 Yrs.",30381,13673,16708
50,7,77,10,"Kanchanpur","45-49 Yrs.",24122,10924,13198
50,7,77,11,"Kanchanpur","50-54 Yrs.",24283,11220,13063
50,7,77,12,"Kanchanpur","55-59 Yrs.",17734,8565,9169
50,7,77,13,"Kanchanpur","60-64 Yrs.",15577,7306,8271
50,7,77,14,"Kanchanpur","65-69 Yrs.",12014,5775,6239
50,7,77,15,"Kanchanpur","70-74 Yrs.",10689,4872,5817
50,7,77,16,"Kanchanpur","75-79 Yrs.",5763,2721,3042
50,7,77,17,"Kanchanpur","80-84 Yrs.",2558,1165,1393
50,7,77,18,"Kanchanpur","85-89 Yrs.",1045,478,567
50,7,77,19,"Kanchanpur","90-94 Yrs.",537,196,341
50,7,77,20,"Kanchanpur","95+ Yrs.",352,112,240
